year,murder,rape,kidnap,robbery,other_crimes,total_crimes,district
2001,161,100,92,646,3268,4267,ADILABAD
2001,276,46,106,947,3101,4476,ANANTAPUR
2001,158,54,118,1701,4344,6375,CHITTOOR
2001,133,40,50,449,2614,3286,CUDDAPAH
2001,149,46,98,2508,4523,7324,EAST GODAVARI
2001,4,0,0,331,217,552,GUNTAKAL RLY.
2001,270,108,164,2660,5500,8702,GUNTUR
2001,224,74,160,6819,6048,13325,HYDERABAD CITY
2001,247,112,134,1080,4169,5742,KARIMNAGAR
2001,153,94,82,922,3545,4796,KHAMMAM
2001,116,74,72,1137,3699,5098,KRISHNA
2001,205,58,94,777,3647,4781,KURNOOL
2001,224,118,84,916,3690,5032,MAHABOOBNAGAR
2001,157,70,52,844,2644,3767,MEDAK
2001,182,70,54,803,4053,5162,NALGONDA
2001,158,92,180,1490,3764,5684,NELLORE
2001,155,42,76,655,2838,3766,NIZAMABAD
2001,184,38,62,732,2847,3863,PRAKASHAM
2001,309,144,212,3773,6277,10715,RANGA REDDY
2001,6,0,0,604,223,833,SECUNDERABAD RLY.
2001,48,16,24,585,2141,2814,SRIKAKULAM
2001,97,50,140,4635,3330,8252,VIJAYAWADA
2001,3,2,0,531,148,684,VIJAYAWADA RLY.
2001,87,24,24,413,2803,3351,VISAKHA RURAL
2001,32,26,26,1589,2246,3919,VISAKHAPATNAM
2001,47,16,16,389,1881,2349,VIZIANAGARAM
2001,237,106,162,1127,4954,6586,WARANGAL
2001,135,122,82,2511,3588,6438,WEST GODAVARI
2001,13,2,6,75,189,285,CHANGLANG
2001,8,4,8,63,178,261,DIBANG VALLEY
2001,4,4,14,67,169,258,KAMENG EAST
2001,6,0,4,59,161,230,KAMENG WEST
2001,22,4,12,92,187,317,LOHIT
2001,19,18,30,310,332,709,PAPUM PARE
2001,7,10,22,141,220,400,SIANG EAST
2001,2,4,10,23,133,172,SIANG UPPER
2001,19,8,34,189,273,523,SIANG WEST
2001,18,4,12,75,166,275,SUBANSIRI LOWER
2001,4,4,2,65,182,257,SUBANSIRI UPPER
2001,2,2,0,29,127,160,TAWANG
2001,12,2,12,54,174,254,TIRAP
2001,69,56,210,556,1227,2118,BARPETA
2001,67,40,72,309,535,1023,BONGAIGAON
2001,0,0,0,2,106,108,C.I.D.
2001,82,90,208,978,2573,3931,CACHAR
2001,74,96,128,531,924,1753,DARRANG
2001,31,84,62,198,485,860,DHEMAJI
2001,88,86,138,318,1090,1720,DHUBRI
2001,132,70,114,807,891,2014,DIBRUGARH
2001,14,2,6,305,258,585,G.R.P.
2001,40,70,86,343,554,1093,GOALPARA
2001,55,60,88,558,748,1509,GOLAGHAT
2001,115,74,258,1814,2915,5176,GUWAHATI CITY
2001,22,48,72,291,596,1029,HAILAKANDI
2001,62,84,74,536,757,1513,JORHAT
2001,67,42,190,818,1263,2380,KAMRUP
2001,91,10,76,216,532,925,KARBI ANGLONG
2001,52,66,84,298,610,1110,KARIMGANJ
2001,114,28,82,244,505,973,KOKRAJHAR
2001,47,128,144,576,1200,2095,LAKHIMPUR
2001,29,46,78,241,552,946,MORIGAON
2001,25,4,16,86,186,317,N.C.HILLS
2001,117,102,238,1364,1963,3784,NAGAON
2001,115,60,106,389,782,1452,NALBARI
2001,11,6,4,74,143,238,R.P.O.
2001,83,94,128,731,1094,2130,SIBSAGAR
2001,111,106,174,938,1493,2822,SONITPUR
2001,124,82,124,869,707,1906,TINSUKIA
2001,74,186,158,485,1523,2426,ARARIA
2001,101,0,26,81,496,704,ARWAL
2001,120,32,48,391,1292,1883,AURANGABAD
2001,101,50,112,247,670,1180,BAGAHA
2001,109,68,54,287,1095,1613,BANKA
2001,201,26,106,691,1950,2974,BEGUSARAI
2001,75,40,168,665,2202,3150,BETTIAH
2001,66,20,86,525,971,1668,BHABHUA
2001,201,70,132,950,1766,3119,BHAGALPUR
2001,168,44,92,623,2234,3161,BHOJPUR
2001,94,16,68,517,1247,1942,BUXAR
2001,117,38,78,337,2153,2723,DARBHANGA
2001,370,50,132,1196,1875,3623,GAYA
2001,199,26,118,499,1461,2303,GOPALGANJ
2001,7,2,8,259,171,447,JAMALPUR RLY.
2001,141,20,28,239,799,1227,JAMUI
2001,153,12,70,334,997,1566,JEHANABAD
2001,107,102,98,420,1377,2104,KATIHAR
2001,7,0,6,492,229,734,KATIHAR RLY.
2001,99,10,68,227,702,1106,KHAGARIA
2001,40,44,46,177,773,1080,KISHANGANJ
2001,105,20,60,205,559,949,LAKHISARAI
2001,79,22,98,200,858,1257,MADHEPURA
2001,100,26,72,323,2561,3082,MADHUBANI
2001,212,88,200,763,2974,4237,MOTIHARI
2001,159,22,90,406,1369,2046,MUNGER
2001,315,146,226,1375,2709,4771,MUZAFFARPUR
2001,16,4,10,653,253,936,MUZAFFARPUR RLY.
2001,457,80,252,1069,2218,4076,NALANDA
2001,101,14,58,107,446,726,NAUGACHIA
2001,131,30,84,218,1227,1690,NAWADAH
2001,1015,54,394,4098,4275,9836,PATNA
2001,45,2,6,1680,292,2025,PATNA RLY.
2001,193,78,128,731,1310,2440,PURNEA
2001,239,50,144,930,2002,3365,ROHTAS
2001,187,24,54,154,787,1206,SAHARSA
2001,222,38,150,697,2053,3160,SAMASTIPUR
2001,207,40,130,756,2696,3829,SARAN
2001,29,6,32,221,713,1001,SHEIKHPURA
2001,18,22,26,52,452,570,SHEOHAR
2001,56,46,68,350,1515,2035,SITAMARHI
2001,266,8,102,449,1245,2070,SIWAN
2001,102,60,52,379,1339,1932,SUPAUL
2001,258,40,180,818,2988,4284,VAISHALI
2001,15,34,2,97,206,354,BALRAMPUR
2001,141,138,40,1973,2725,5017,BILASPUR
2001,22,8,0,23,143,196,BIZAPUR
2001,120,38,22,199,534,913,DANTEWARA
2001,20,44,8,347,761,1180,DHAMTARI
2001,142,288,114,2439,4366,7349,DURG
2001,3,0,0,413,194,610,GRP RAIPUR
2001,115,118,12,515,1320,2080,JAGDALPUR
2001,77,58,18,695,1453,2301,JANJGIR
2001,53,72,4,220,495,844,JASHPUR
2001,48,84,8,182,593,915,KANKER
2001,31,70,2,159,553,815,KAWARDHA
2001,46,92,26,839,1433,2436,KORBA
2001,60,68,14,545,1137,1824,KORIYA
2001,38,86,14,408,830,1376,MAHASAMUND
2001,74,106,12,576,1058,1826,RAIGARH
2001,194,208,76,2772,4384,7634,RAIPUR
2001,63,116,8,770,1974,2931,RAJNANDGAON
2001,147,290,34,1040,1938,3449,SARGUJA
2001,38,8,8,786,764,1604,NORTH GOA
2001,28,16,10,757,608,1419,SOUTH GOA
2001,148,78,286,8085,8314,16911,AHMEDABAD COMMR.
2001,43,10,54,613,1731,2451,AHMEDABAD RURAL
2001,6,2,4,23,218,253,AHWA-DANG
2001,52,4,78,554,1790,2478,AMRELI
2001,44,6,60,1073,3044,4227,ANAND
2001,51,8,78,956,2334,3427,BHARUCH
2001,92,18,120,1378,3921,5529,BHAVNAGAR
2001,44,10,30,382,1452,1918,DAHOD
2001,36,8,30,1388,2612,4074,GANDHINAGAR
2001,64,34,62,638,3394,4192,HIMATNAGAR
2001,75,40,54,1286,2992,4447,JAMNAGAR
2001,93,28,92,1402,4019,5634,JUNAGADH
2001,47,22,60,903,3162,4194,KHEDA NORTH
2001,63,4,48,766,2809,3690,KUTCH
2001,45,8,116,1382,4163,5714,MEHSANA
2001,19,16,18,107,518,678,NARMADA
2001,32,4,12,359,1161,1568,NAVSARI
2001,97,36,82,1112,2984,4311,PALANPUR
2001,69,10,92,813,1931,2915,PANCHMAHAL
2001,42,6,42,543,2058,2691,PATAN
2001,24,12,10,279,1058,1383,PORBANDAR
2001,62,10,92,2832,3031,6027,RAJKOT COMMR.
2001,66,40,80,986,3508,4680,RAJKOT RURAL
2001,117,22,114,3287,1743,5283,SURAT COMMR.
2001,70,52,46,580,1310,2058,SURAT RURAL
2001,55,22,58,532,2672,3339,SURENDRANAGAR
2001,48,6,70,2281,3484,5889,VADODARA COMMR.
2001,84,36,76,523,2630,3349,VADODARA RURAL
2001,52,18,32,1157,2311,3570,VALSAD
2001,23,2,0,1927,448,2400,W.RLY
2001,49,22,76,1071,1528,2746,AMBALA
2001,60,20,18,541,1424,2063,BHIWANI
2001,106,74,156,1648,4479,6463,FARIDABAD
2001,41,34,40,397,912,1424,FATEHABAD
2001,27,0,4,344,510,885,GRP
2001,99,64,100,1952,2157,4372,GURGAON
2001,98,20,52,1160,1856,3186,HISSAR
2001,76,42,28,491,1071,1708,JHAJJAR
2001,58,42,24,505,963,1592,JIND
2001,48,32,18,407,860,1365,KAITHAL
2001,66,88,62,1171,1529,2916,KARNAL
2001,28,62,28,840,1105,2063,KURUKSHETRA
2001,36,22,26,293,974,1351,MAHENDRAGARH
2001,19,12,36,576,700,1343,PANCHKULA
2001,69,76,38,1087,1109,2379,PANIPAT
2001,34,22,26,405,960,1447,REWARI
2001,86,56,26,997,1098,2263,ROHTAK
2001,70,34,36,682,1240,2062,SIRSA
2001,122,30,52,864,1289,2357,SONIPAT
2001,56,44,52,527,1011,1690,YAMUNANAGAR
2001,18,10,20,153,983,1184,BILASPUR
2001,16,24,34,151,456,681,CHAMBA
2001,1,0,0,2,106,109,G.R.P.
2001,7,6,6,64,757,840,HAMIRPUR
2001,40,36,60,367,1716,2219,KANGRA
2001,5,12,6,28,205,256,KINNAUR
2001,14,26,14,85,610,749,KULLU
2001,1,4,2,8,142,157,LAHAUL-SPITI
2001,26,32,22,238,1537,1855,MANDI
2001,27,36,26,553,1549,2191,SHIMLA
2001,8,20,26,95,661,810,SIRMAUR
2001,19,24,26,196,1002,1267,SOLAN
2001,12,18,10,136,671,847,UNA
2001,115,12,118,313,712,1270,ANANTNAG
2001,28,2,28,63,324,445,AWANTIPORA
2001,299,56,150,444,838,1787,BARAMULLA
2001,48,24,20,62,662,816,BORDER
2001,181,14,80,255,477,1007,BUDGAM
2001,0,0,0,0,104,104,CRIME JAMMU
2001,0,0,0,0,104,104,CRIME SRINAGAR
2001,251,14,30,63,397,755,DODA
2001,32,10,66,117,321,546,GANDERBAL
2001,109,26,86,1200,2707,4128,JAMMU
2001,0,0,4,14,175,193,KARGIL
2001,44,26,22,127,740,959,KATHUA
2001,55,12,70,140,526,803,KULGAM
2001,410,12,94,115,512,1143,KUPWARA
2001,4,0,2,19,216,241,LEH
2001,289,26,32,148,458,953,POONCH
2001,136,14,74,382,537,1143,PULWAMA
2001,2,0,0,7,115,124,RAILWAYS
2001,173,34,40,76,778,1101,RAJOURI
2001,101,6,14,37,493,651,RAMBAN
2001,111,14,22,53,316,516,REASI
2001,112,16,230,1427,1650,3435,SRINAGAR
2001,49,20,30,306,826,1231,UDHAMPUR
2001,145,52,76,1084,1123,2480,BOKARO
2001,143,64,34,254,380,875,CHAIBASA
2001,50,12,20,228,625,935,CHATRA
2001,129,44,14,354,788,1329,DEOGHAR
2001,128,64,114,1407,1800,3513,DHANBAD
2001,11,4,8,452,196,671,DHANBAD RLY.
2001,95,54,48,201,793,1191,DUMKA
2001,38,22,10,176,693,939,GARHWA
2001,128,84,30,421,1441,2104,GIRIDIH
2001,61,74,60,248,825,1268,GODDA
2001,154,58,32,217,381,842,GUMLA
2001,111,82,84,1002,1672,2951,HAZARIBAGH
2001,271,100,120,859,1653,3003,JAMSHEDPUR
2001,4,2,0,143,165,314,JAMSHEDPUR RLY.
2001,52,36,28,174,362,652,JAMTARA
2001,39,4,28,209,542,822,KODERMA
2001,62,24,8,165,282,541,LATEHAR
2001,37,24,28,89,278,456,LOHARDAGGA
2001,50,46,14,103,416,629,PAKUR
2001,125,30,28,337,1130,1650,PALAMU
2001,308,146,2,1521,306,2283,RANCHI
2001,81,40,34,205,439,799,SAHEBGANJ
2001,100,34,38,321,369,862,SARAIKELA
2001,51,34,24,81,200,390,SIMDEGA
2001,93,4,34,262,1472,1865,BAGALKOT
2001,548,80,304,15034,15683,31649,BANGALORE COMMR.
2001,223,26,74,1526,3873,5722,BANGALORE RURAL
2001,175,16,54,1050,4100,5395,BELGAUM
2001,99,32,28,810,2586,3555,BELLARY
2001,106,14,38,603,3808,4569,BIDAR
2001,98,12,48,538,2488,3184,BIJAPUR
2001,37,8,10,349,1176,1580,CHAMARAJNAGAR
2001,65,16,24,606,2309,3020,CHICKMAGALUR
2001,53,36,8,433,2355,2885,CHITRADURGA
2001,69,6,18,661,2534,3288,DAKSHIN KANNADA
2001,97,44,46,942,2505,3634,DAVANAGERE
2001,40,8,16,688,1444,2196,DHARWAD COMMR.
2001,35,6,6,114,855,1016,DHARWAD RURAL
2001,39,4,8,182,793,1026,GADAG
2001,178,40,70,856,3232,4376,GULBARGA
2001,133,40,34,726,3414,4347,HASSAN
2001,41,6,24,324,1971,2366,HAVERI
2001,42,2,24,320,716,1104,K.G.F.
2001,59,8,8,283,1110,1468,KODAGU
2001,141,34,42,752,2584,3553,KOLAR
2001,56,12,24,322,1171,1585,KOPPAL
2001,114,30,18,881,4130,5173,MANDYA
2001,66,4,22,793,1384,2269,MYSORE COMMR.
2001,111,24,28,567,2400,3130,MYSORE RURAL
2001,71,24,22,457,1913,2487,RAICHUR
2001,12,2,2,685,316,1017,RAILWAYS
2001,104,24,28,806,3537,4499,SHIMOGA
2001,135,12,42,1053,3323,4565,TUMKUR
2001,30,4,4,330,1776,2144,UDUPI
2001,31,8,10,238,2177,2464,UTTAR KANNADA
2001,54,42,16,637,6564,7313,ALAPUZHA
2001,29,4,4,17,254,308,CBCID
2001,111,76,40,3225,12359,15811,ERNAKULAM
2001,63,68,0,767,4636,5534,IDUKKI
2001,84,84,24,722,5064,5978,KANNUR
2001,41,56,8,463,2761,3329,KASARGOD
2001,106,110,32,991,8117,9356,KOLLAM
2001,60,44,36,1121,5933,7194,KOTTAYAM
2001,69,78,24,1348,7004,8523,KOZHIKODE
2001,56,142,34,985,6395,7612,MALAPPURAM
2001,102,126,28,1013,5392,6661,PALAKKAD
2001,33,24,0,410,3697,4164,PATHANAMTHITTA
2001,0,2,0,397,191,590,RAILWAYS
2001,121,84,36,1534,8697,10472,THRISSUR
2001,132,114,82,2017,9081,11426,TRIVANDRUM
2001,26,70,2,415,1676,2189,WAYANADU
2001,99,174,22,693,2180,3168,BALAGHAT
2001,71,68,4,626,1521,2290,BARWANI
2001,104,190,38,709,1903,2944,BETUL
2001,160,62,94,828,2563,3707,BHIND
2001,170,212,110,3667,10688,14847,BHOPAL
2001,8,2,4,1446,370,1830,BHOPAL RLY.
2001,126,130,56,616,2563,3491,CHHATARPUR
2001,129,186,36,662,2825,3838,CHHINDWARA
2001,121,132,36,518,2238,3045,DAMOH
2001,108,24,50,323,1539,2044,DATIYA
2001,162,156,40,1799,3444,5601,DEWAS
2001,188,136,44,1638,3523,5529,DHAR
2001,17,40,4,142,724,927,DINDORI
2001,143,248,34,1219,4590,6234,GUNA
2001,252,118,92,2942,4329,7733,GWALIOR
2001,26,56,4,195,629,910,HARDA
2001,110,130,32,856,1915,3043,HOSHANGABAD
2001,244,168,100,6417,8656,15585,INDORE
2001,10,4,0,397,229,640,INDORE RLY.
2001,270,216,66,2499,6068,9119,JABALPUR
2001,3,0,0,458,215,676,JABALPUR RLY.
2001,243,88,166,731,2543,3771,JHABUA
2001,88,50,18,675,1697,2528,KATNI
2001,87,126,28,908,2996,4145,KHANDWA
2001,88,94,30,1272,2513,3997,KHARGON
2001,48,128,18,435,1604,2233,MANDLA
2001,61,82,30,1120,1783,3076,MANDSAUR
2001,162,70,70,1604,3965,5871,MORENA
2001,87,140,14,432,1801,2474,NARSINGHPUR
2001,35,74,32,975,1486,2602,NEEMUCH
2001,50,88,22,354,1550,2064,PANNA
2001,118,158,22,522,2354,3174,RAISEN
2001,110,190,24,610,2996,3930,RAJGARH
2001,118,140,42,1234,2296,3830,RATLAM
2001,107,62,52,1601,3223,5045,REWA
2001,206,282,60,1524,5806,7878,SAGAR
2001,97,116,32,1635,3383,5263,SATNA
2001,65,104,6,452,1700,2327,SEONI
2001,85,126,26,1281,2958,4476,SHAHDOL
2001,88,180,26,1500,2471,4265,SHAJAPUR
2001,54,42,36,260,829,1221,SHEOPUR
2001,151,144,40,846,3379,4560,SHIVPURI
2001,57,84,66,1032,2660,3899,SIDHI
2001,89,118,58,1105,2401,3771,SIHORE
2001,99,172,14,552,2418,3255,TIKAMGARH
2001,247,118,88,3686,4846,8985,UJJAIN
2001,31,50,6,405,1535,2027,UMARIYA
2001,103,224,20,734,2772,3853,VIDISHA
2001,138,88,74,1872,2948,5120,AHMEDNAGAR
2001,105,30,30,1818,2723,4706,AKOLA
2001,73,46,54,1941,1592,3706,AMRAVATI COMMR.
2001,95,84,58,2458,2024,4719,AMRAVATI RURAL
2001,63,28,38,1290,1405,2824,AURANGABAD COMMR.
2001,73,56,32,803,2064,3028,AURANGABAD RURAL
2001,111,44,50,1341,2614,4160,BEED
2001,54,78,8,1016,1540,2696,BHANDARA
2001,81,44,44,1764,2483,4416,BULDHANA
2001,75,86,20,1441,2068,3690,CHANDRAPUR
2001,73,32,12,839,1496,2452,DHULE
2001,71,54,14,401,1013,1553,GADCHIROLI
2001,58,46,34,911,1291,2340,GONDIA
2001,63,40,18,646,1378,2145,HINGOLI
2001,127,38,32,1403,2874,4474,JALGAON
2001,67,32,24,959,1817,2899,JALNA
2001,87,52,42,1467,2071,3719,KOLHAPUR
2001,59,14,44,755,2471,3343,LATUR
2001,495,254,296,26538,11385,38968,MUMBAI
2001,21,4,2,3547,246,3820,MUMBAI RLY.
2001,182,78,128,6960,5023,12371,NAGPUR COMMR.
2001,13,4,0,1552,339,1908,NAGPUR RLY.
2001,157,162,46,2715,3681,6761,NAGPUR RURAL
2001,146,46,82,1629,3895,5798,NANDED
2001,64,32,12,341,836,1285,NANDURBAR
2001,39,18,28,1345,1321,2751,NASIK COMMR.
2001,146,78,34,1250,3793,5301,NASIK RURAL
2001,52,34,38,2254,1459,3837,NAVI MUMBAI
2001,61,32,16,925,2041,3075,OSMANABAD
2001,77,50,44,653,1919,2743,PARBHANI
2001,115,112,92,5981,4861,11161,PUNE COMMR.
2001,5,0,0,609,169,783,PUNE RLY.
2001,160,84,48,1684,3058,5034,PUNE RURAL
2001,64,40,16,839,1598,2557,RAIGAD
2001,22,20,16,628,1052,1738,RATNAGIRI
2001,109,64,36,1293,2025,3527,SANGLI
2001,76,64,24,1222,2508,3894,SATARA
2001,18,14,4,342,616,994,SINDHUDURG
2001,44,32,30,817,1013,1936,SOLAPUR COMMR.
2001,131,70,46,924,2395,3566,SOLAPUR RURAL
2001,214,78,124,4795,2759,7970,THANE COMMR.
2001,173,130,56,1649,2271,4279,THANE RURAL
2001,85,70,24,1476,2385,4040,WARDHA
2001,50,30,26,963,1225,2294,WASHIM
2001,101,112,74,1845,2813,4945,YAVATMAL
2001,54,2,6,33,243,338,BISHNUPUR
2001,14,0,2,24,138,178,CHANDEL
2001,56,2,0,28,160,246,CHURACHANDPUR
2001,58,14,26,69,296,463,IMPHAL(EAST)
2001,86,14,96,283,823,1302,IMPHAL(WEST)
2001,37,0,12,21,221,291,SENAPATI
2001,3,0,0,9,110,122,TAMENGLONG
2001,64,8,44,71,346,533,THOUBAL
2001,5,0,2,27,124,158,UKHRUL
2001,25,4,10,60,157,256,GARO HILLS EAST
2001,9,2,4,25,124,164,GARO HILLS SOUTH
2001,22,10,28,107,209,376,GARO HILLS WEST
2001,38,14,12,92,198,354,JAINTIA HILLS
2001,75,10,40,491,367,983,KHASI HILLS EAST
2001,18,8,0,81,146,253,KHASI HILLS WEST
2001,24,4,16,81,181,306,RI-BHOI
2001,18,52,0,1397,273,1740,AIZAWL
2001,3,14,2,139,191,349,CHAMPHAI
2001,4,12,0,185,183,384,KOLASIB
2001,2,4,0,61,222,289,LAWNGTLAI
2001,9,6,0,288,136,439,LUNGLEI
2001,4,0,0,39,145,188,MAMIT
2001,4,6,0,30,237,277,SAIHA
2001,2,10,2,60,116,190,SERCHHIP
2001,41,8,26,376,227,678,DIMAPUR
2001,1,0,0,12,114,127,KIPHIRE
2001,41,12,6,183,243,485,KOHIMA
2001,14,2,2,44,142,204,MOKOKCHUNG
2001,6,4,4,31,122,167,MON
2001,2,0,0,18,115,135,PEREN
2001,11,2,4,27,121,165,PHEK
2001,4,0,0,20,122,146,TUENSANG
2001,15,2,4,70,136,227,WOKHA
2001,5,4,0,38,122,169,ZUNHEBOTO
2001,66,66,10,457,1048,1647,ANGUL
2001,27,116,74,559,1797,2573,BALASORE
2001,59,38,16,407,929,1449,BARAGARH
2001,75,20,26,462,883,1466,BERHAMPUR
2001,37,70,40,285,1125,1557,BHADRAK
2001,42,38,32,303,1018,1433,BOLANGIR
2001,15,12,10,106,398,541,BOUDH
2001,178,68,86,1924,2747,5003,CUTTACK
2001,18,16,8,77,345,464,DEOGARH
2001,55,30,28,245,906,1264,DHENKANAL
2001,26,20,10,96,411,563,GAJAPATI
2001,150,44,28,385,1321,1928,GANJAM
2001,47,24,42,384,1058,1555,JAGATSINGHPUR
2001,37,48,28,393,1260,1766,JAJPUR
2001,44,24,10,227,590,895,JHARSUGUDA
2001,63,60,34,260,1039,1456,KALAHANDI
2001,34,68,50,325,685,1162,KANDHAMAL
2001,60,22,30,237,833,1182,KENDRAPARA
2001,93,76,38,413,1459,2079,KEONJHAR
2001,131,130,78,2566,3150,6055,KHURDA
2001,69,76,26,418,1177,1766,KORAPUT
2001,63,28,12,127,394,624,MALKANGIR
2001,119,154,62,573,1350,2258,MAYURBHANJ
2001,69,34,46,178,706,1033,NAYAGARH
2001,41,26,22,239,521,849,NOWRANGPUR
2001,15,18,8,115,443,599,NUAPADA
2001,121,82,64,648,1650,2565,PURI
2001,52,18,12,174,728,984,RAYAGADA
2001,42,24,12,580,826,1484,ROURKELA
2001,129,36,26,866,1408,2465,SAMBALPUR
2001,29,16,8,106,393,552,SONEPUR
2001,6,2,10,596,235,849,SRP(CUTTACK)
2001,8,4,6,293,199,510,SRP(ROURKELA)
2001,118,72,52,492,1147,1881,SUNDARGARH
2001,79,18,68,447,761,1373,AMRITSAR
2001,44,24,32,109,395,604,BARNALA
2001,42,16,12,75,340,485,BATALA
2001,63,26,30,281,705,1105,BHATINDA
2001,19,12,22,147,374,574,FARIDKOT
2001,39,22,24,169,542,796,FATEHGARH SAHIB
2001,103,44,24,309,732,1212,FEROZEPUR
2001,10,0,0,90,441,541,G.R.P
2001,42,24,34,104,501,705,GURDASPUR
2001,77,38,40,346,849,1350,HOSHIARPUR
2001,60,38,38,226,459,821,JAGRAON
2001,146,42,140,819,1483,2630,JALANDHAR
2001,44,16,34,193,499,786,KAPURTHALA
2001,34,12,8,128,420,602,KHANNA
2001,142,76,176,1553,2162,4109,LUDHIANA
2001,51,18,20,78,429,596,MAJITHA
2001,46,12,10,116,352,536,MANSA
2001,55,22,28,188,570,863,MOGA
2001,46,6,6,142,338,538,MUKTSAR
2001,36,22,26,175,445,704,NAWAN SHAHR
2001,130,46,120,1575,4272,6143,PATIALA
2001,45,12,48,324,970,1399,ROPAR
2001,91,30,56,444,821,1442,SANGRUR
2001,83,20,30,170,446,749,TARN TARAN
2001,86,32,266,1997,4815,7196,AJMER
2001,168,68,238,2270,4979,7723,ALWAR
2001,64,180,122,360,2978,3704,BANSWARA
2001,131,162,192,966,3187,4638,BARAN
2001,37,26,42,490,1957,2552,BARMER
2001,173,96,252,1814,5622,7957,BHARATPUR
2001,88,84,446,1990,4356,6964,BHILWARA
2001,122,70,72,1026,2987,4277,BIKANER
2001,105,72,240,1041,2973,4431,BUNDI
2001,100,134,412,1915,5170,7731,CHITTORGARH
2001,66,48,52,561,2291,3018,CHURU
2001,49,18,80,928,2854,3929,DAUSA
2001,118,48,86,593,2548,3393,DHOLPUR
2001,40,34,108,235,1716,2133,DUNGARPUR
2001,5,2,14,1191,416,1628,G.R.P.
2001,148,110,158,1086,4184,5686,GANGANAGAR
2001,139,70,98,906,2862,4075,HANUMANGARH
2001,181,122,494,7615,14306,22718,JAIPUR
2001,9,4,16,339,851,1219,JAISALMER
2001,52,20,64,430,2105,2671,JALORE
2001,137,130,178,1036,2427,3908,JHALAWAR
2001,56,38,90,957,3313,4454,JHUNJHUNU
2001,109,40,156,2025,4575,6905,JODHPUR
2001,35,42,144,676,2391,3288,KARAULI
2001,368,100,292,2972,4609,8341,KOTA
2001,65,44,118,1114,3578,4919,NAGAUR
2001,96,50,154,795,3677,4772,PALI
2001,31,26,126,474,2409,3066,RAJSAMAND
2001,42,38,124,756,2444,3404,SAWAI MADHOPUR
2001,77,26,96,984,3436,4619,SIKAR
2001,66,44,48,417,1747,2322,SIROHI
2001,51,34,136,762,3198,4181,TONK
2001,168,86,322,1430,4883,6889,UDAIPUR
2001,20,14,8,161,225,428,EAST
2001,1,0,0,8,131,140,NORTH
2001,7,2,2,27,154,192,SOUTH
2001,2,0,2,31,132,167,WEST
2001,65,12,50,288,1533,1948,ARIYALUR
2001,176,40,16,2381,5321,7934,CHENGAI
2001,389,56,80,5141,3269,8935,CHENNAI
2001,6,0,0,317,416,739,CHENNAI RLY.
2001,126,36,76,2415,7414,10067,COIMBATORE RURAL
2001,36,8,28,2102,2241,4415,COIMBATORE URBAN
2001,237,32,42,1297,6936,8544,CUDDALORE
2001,176,34,70,1097,4225,5602,DHARMAPURI
2001,146,28,98,1143,3804,5219,DINDIGUL
2001,85,18,90,1565,5487,7245,ERODE
2001,106,42,26,1225,5015,6414,KANCHIPURAM
2001,98,12,26,755,3171,4062,KANYAKUMARI
2001,40,8,22,504,1973,2547,KARUR
2001,115,26,60,894,4145,5240,MADURAI RURAL
2001,87,4,52,1846,2780,4769,MADURAI URBAN
2001,110,24,58,733,3191,4116,NAGAPATTINAM
2001,67,14,32,371,2401,2885,NAMAKKAL
2001,31,16,10,318,1158,1533,NILGIRIS
2001,26,6,26,130,1021,1209,PERAMBALUR
2001,60,10,54,564,3059,3747,PUDUKOTTAI
2001,85,26,52,455,2841,3459,RAMNATHAPURAM
2001,121,16,70,461,3835,4503,SALEM RURAL
2001,26,4,20,1027,1287,2364,SALEM URBAN
2001,77,10,32,829,2488,3436,SIVAGANGAI
2001,123,0,110,1060,2714,4007,THANJAVUR
2001,33,8,36,577,2267,2921,THENI
2001,198,114,132,1460,5010,6914,THIRUNELVELI RURAL
2001,61,6,30,542,1266,1905,THIRUNELVELI URBAN
2001,90,32,48,571,2991,3732,THIRUVALLUR
2001,78,10,80,981,4063,5212,THIRUVANNAMALAI
2001,87,14,60,466,2673,3300,THIRUVARUR
2001,167,24,76,1175,4340,5782,THOOTHUGUDI
2001,0,0,0,83,266,349,TRICHY RLY.
2001,92,12,38,476,2788,3406,TRICHY RURAL
2001,43,10,22,1124,1630,2829,TRICHY URBAN
2001,134,26,32,1832,6668,8692,VELLORE
2001,159,74,106,840,6358,7537,VILLUPURAM
2001,110,34,44,1174,3652,5014,VIRUDHUNAGAR
2001,35,22,30,30,220,337,DHALAI
2001,49,58,38,159,441,745,NORTH
2001,46,58,40,115,495,754,SOUTH
2001,135,66,78,501,976,1756,WEST
2001,315,132,406,3018,3840,7711,AGRA
2001,471,100,246,1869,2630,5316,ALIGARH
2001,391,84,192,2162,4083,6912,ALLAHABAD
2001,95,38,58,353,1022,1566,AMBEDKAR NAGAR
2001,106,22,122,233,866,1349,AURAIYA
2001,223,22,90,606,1502,2443,AZAMGARH
2001,511,94,164,823,1827,3419,BADAUN
2001,249,30,62,552,737,1630,BAGHPAT
2001,92,28,56,443,905,1524,BAHRAICH
2001,146,36,48,505,1477,2212,BALLIA
2001,54,16,40,207,557,874,BALRAMPUR
2001,128,54,58,341,1269,1850,BANDA
2001,173,82,142,930,1655,2982,BARABANKI
2001,603,186,288,1963,2949,5989,BAREILLY
2001,99,36,56,475,1261,1927,BASTI
2001,237,76,170,905,1420,2808,BIJNOR
2001,459,62,188,1151,2538,4398,BULANDSHAHAR
2001,65,8,40,238,535,886,CHANDOLI
2001,44,16,10,83,332,485,CHITRAKOOT DHAM
2001,145,14,78,441,1912,2590,DEORIA
2001,604,114,236,947,2948,4849,ETAH
2001,174,40,186,428,1382,2210,ETAWAH
2001,125,44,56,640,1356,2221,FAIZABAD
2001,206,18,126,322,1181,1853,FATEHGARH
2001,188,56,90,381,1410,2125,FATEHPUR
2001,304,44,240,783,1739,3110,FIROZABAD
2001,51,4,8,6358,1086,7507,G.R.P.
2001,152,32,84,1573,1260,3101,GAUTAMBUDH NAGAR
2001,611,62,224,3070,2303,6270,GHAZIABAD
2001,104,12,56,325,968,1465,GHAZIPUR
2001,169,36,68,488,1103,1864,GONDA
2001,170,26,120,565,1867,2748,GORAKHPUR
2001,99,28,48,315,723,1213,HAMIRPUR
2001,335,140,150,698,2056,3379,HARDOI
2001,180,32,100,629,1464,2405,HATHRAS
2001,184,46,94,417,1152,1893,J.P.NAGAR
2001,162,12,72,476,1267,1989,JALAUN
2001,141,22,44,474,1451,2132,JAUNPUR
2001,124,36,84,653,1364,2261,JHANSI
2001,134,16,80,283,917,1430,KANNAUJ
2001,152,42,100,373,1110,1777,KANPUR DEHAT
2001,408,94,420,3138,3805,7865,KANPUR NAGAR
2001,122,52,62,427,998,1661,KAUSHAMBI
2001,350,166,224,1245,2284,4269,KHIRI
2001,117,14,68,286,1113,1598,KUSHI NAGAR
2001,43,40,10,174,629,896,LALITPUR
2001,355,124,350,5226,4867,10922,LUCKNOW
2001,61,26,38,161,683,969,MAHARAJGANJ
2001,92,24,26,182,544,868,MAHOBA
2001,287,26,112,580,1330,2335,MAINPURI
2001,295,50,124,970,1862,3301,MATHURA
2001,98,34,60,344,960,1496,MAU
2001,514,56,320,2917,2704,6511,MEERUT
2001,111,32,28,416,815,1402,MIRZAPUR
2001,384,88,204,1495,1890,4061,MORADABAD
2001,579,108,284,1637,2140,4748,MUZAFFARNAGAR
2001,348,128,132,559,1326,2493,PILIBHIT
2001,199,36,86,457,1816,2594,PRATAPGARH
2001,150,116,116,812,1707,2901,RAIBAREILLY
2001,187,44,88,649,996,1964,RAMPUR
2001,229,82,150,1013,1762,3236,SAHARANPUR
2001,32,18,34,100,525,709,SANT KABIRNAGAR
2001,419,110,224,848,1729,3330,SHAHJAHANPUR
2001,65,26,42,285,512,930,SHRAWASTI
2001,31,24,48,261,615,979,SIDHARTHNAGAR
2001,301,170,198,1989,2870,5528,SITAPUR
2001,56,10,18,248,414,746,SONBHADRA
2001,45,2,16,263,447,773,ST.RAVIDASNAGAR
2001,257,58,94,797,1641,2847,SULTANPUR
2001,288,106,194,891,2475,3954,UNNAO
2001,167,54,110,1335,1738,3404,VARANASI
2001,30,8,2,136,216,392,ALMORA
2001,17,2,8,32,173,232,BAGESHWAR
2001,19,6,6,97,201,329,CHAMOLI
2001,6,0,6,39,181,232,CHAMPAWAT
2001,98,24,108,994,1151,2375,DEHRADUN
2001,169,26,104,809,1090,2198,HARIDWAR
2001,67,10,28,399,576,1080,NAINITAL
2001,35,14,14,214,298,575,PAURI GARHWAL
2001,11,14,2,117,352,496,PITHORAGARH
2001,7,4,0,44,171,226,RUDRA PRAYAG
2001,17,4,10,107,310,448,TEHRI GARHWAL
2001,98,20,72,499,754,1443,UDHAMSINGH NAGAR
2001,21,16,6,110,292,445,UTTARKASHI
2001,225,106,162,3474,3903,7870,24 PARGANAS NORTH
2001,112,94,106,2350,4378,7040,24 PARGANAS SOUTH
2001,16,0,6,121,369,512,ASANSOL
2001,67,52,14,537,819,1489,BANKURA
2001,116,86,86,783,1590,2661,BIRBHUM
2001,137,92,90,1807,3423,5549,BURDWAN
2001,38,72,86,294,1009,1499,COOCHBEHAR
2001,25,20,62,277,834,1218,DAKSHIN DINAJPUR
2001,49,40,42,997,1201,2329,DARJEELING
2001,103,58,82,1288,2151,3682,HOOGHLY
2001,36,4,22,351,1020,1433,HOWRAH
2001,29,14,34,801,946,1824,HOWRAH CITY
2001,18,2,14,1372,321,1727,HOWRAH G.R.P.
2001,182,108,66,1101,1416,2873,JALPAIGURI
2001,217,38,242,8463,5985,14945,KOLKATA
2001,82,80,76,702,1321,2261,MALDA
2001,140,168,148,1309,3532,5297,MIDNAPUR
2001,140,132,104,818,1995,3189,MURSHIDABAD
2001,124,142,182,1431,2577,4456,NADIA
2001,69,46,34,639,872,1660,PURULIA
2001,29,2,6,571,183,791,SEALDAH G.R.P.
2001,2,0,4,187,140,333,SILIGURI G.R.P.
2001,87,62,82,598,1077,1906,UTTAR DINAJPUR
2001,13,6,4,196,556,775,ANDAMAN
2001,0,0,0,2,122,124,NICOBAR
2001,25,36,112,3449,1271,4893,CHANDIGARH
2001,5,12,8,126,326,477,D and N HAVELI
2001,11,0,10,107,198,326,DAMAN
2001,1,0,0,16,135,152,DIU
2001,71,56,124,3385,1678,5314,CENTRAL
2001,107,48,326,3638,2015,6134,EAST
2001,15,2,14,2874,242,3147,G.R.P.(RLY)
2001,4,0,8,106,177,295,I.G.I. AIRPORT
2001,25,18,54,2572,1016,3685,NEW DELHI
2001,61,56,198,2964,2038,5317,NORTH
2001,141,72,314,2162,1895,4584,NORTH EAST
2001,241,206,1036,6464,5320,13267,NORTH WEST
2001,0,0,0,0,104,104,S.T.F.
2001,158,130,530,9382,4623,14823,SOUTH
2001,113,84,348,4078,2619,7242,SOUTH WEST
2001,121,90,302,4702,4562,9777,WEST
2001,1,0,0,21,127,149,LAKSHADWEEP
2001,57,18,8,1172,3394,4649,PONDICHERRY
2002,179,74,84,692,3704,4733,ADILABAD
2002,279,56,130,942,3281,4688,ANANTAPUR
2002,171,56,134,1890,4726,6977,CHITTOOR
2002,91,32,54,506,2818,3501,CUDDAPAH
2002,199,50,110,2895,5606,8860,EAST GODAVARI
2002,0,2,0,298,260,560,GUNTAKAL RLY.
2002,220,92,174,2786,5432,8704,GUNTUR
2002,226,114,230,8983,6911,16464,HYDERABAD CITY
2002,248,198,124,1102,5319,6991,KARIMNAGAR
2002,161,96,140,1042,4373,5812,KHAMMAM
2002,158,82,52,1333,4028,5653,KRISHNA
2002,222,90,108,775,3636,4831,KURNOOL
2002,255,170,114,1163,3989,5691,MAHABOOBNAGAR
2002,153,136,92,1037,3114,4532,MEDAK
2002,162,82,92,832,4184,5352,NALGONDA
2002,177,92,134,1328,3862,5593,NELLORE
2002,135,70,58,898,3508,4669,NIZAMABAD
2002,146,42,64,675,2854,3781,PRAKASHAM
2002,321,98,208,3994,6848,11469,RANGA REDDY
2002,12,0,0,706,175,893,SECUNDERABAD RLY.
2002,36,28,20,574,2047,2705,SRIKAKULAM
2002,88,62,156,6398,4460,11164,VIJAYAWADA
2002,3,2,2,657,173,837,VIJAYAWADA RLY.
2002,79,28,14,495,2244,2860,VISAKHA RURAL
2002,35,16,30,1404,1757,3242,VISAKHAPATNAM
2002,50,24,18,453,2080,2625,VIZIANAGARAM
2002,203,104,144,1098,5050,6599,WARANGAL
2002,160,108,118,1964,4165,6515,WEST GODAVARI
2002,13,6,10,75,200,304,CHANGLANG
2002,10,10,12,67,207,306,DIBANG VALLEY
2002,5,2,8,59,177,251,KAMENG EAST
2002,6,0,8,40,151,205,KAMENG WEST
2002,16,6,10,71,191,294,LOHIT
2002,6,6,20,303,242,577,PAPUM PARE
2002,3,22,20,152,227,424,SIANG EAST
2002,1,6,0,24,127,158,SIANG UPPER
2002,11,8,14,147,290,470,SIANG WEST
2002,11,2,8,90,177,288,SUBANSIRI LOWER
2002,7,4,2,47,184,244,SUBANSIRI UPPER
2002,0,2,0,29,128,159,TAWANG
2002,10,2,2,53,197,264,TIRAP
2002,63,110,138,647,986,1944,BARPETA
2002,47,42,102,285,571,1047,BONGAIGAON
2002,0,0,4,0,149,153,C.I.D.
2002,101,142,186,1150,2418,3997,CACHAR
2002,38,66,108,312,563,1087,DARRANG
2002,45,96,62,211,488,902,DHEMAJI
2002,76,92,124,322,1261,1875,DHUBRI
2002,132,90,150,757,992,2121,DIBRUGARH
2002,6,0,0,134,140,280,G.R.P.
2002,42,80,96,312,635,1165,GOALPARA
2002,66,84,136,624,812,1722,GOLAGHAT
2002,78,120,368,2933,2049,5548,GUWAHATI CITY
2002,31,48,84,301,582,1046,HAILAKANDI
2002,50,72,72,493,741,1428,JORHAT
2002,65,82,236,395,1194,1972,KAMRUP
2002,44,10,74,284,361,773,KARBI ANGLONG
2002,55,46,76,365,627,1169,KARIMGANJ
2002,82,30,96,228,633,1069,KOKRAJHAR
2002,60,138,168,707,1223,2296,LAKHIMPUR
2002,31,80,78,256,570,1015,MORIGAON
2002,41,4,18,104,193,360,N.C.HILLS
2002,118,122,264,1083,2042,3629,NAGAON
2002,103,54,100,311,675,1243,NALBARI
2002,0,2,2,11,108,123,R.P.O.
2002,95,114,114,736,1286,2345,SIBSAGAR
2002,131,134,228,889,1358,2740,SONITPUR
2002,132,82,106,862,727,1909,TINSUKIA
2002,76,202,182,353,1643,2456,ARARIA
2002,102,0,22,105,502,731,ARWAL
2002,134,24,38,376,1965,2537,AURANGABAD
2002,98,46,98,283,717,1242,BAGAHA
2002,118,54,64,312,1186,1734,BANKA
2002,277,40,150,678,2269,3414,BEGUSARAI
2002,329,110,134,753,2263,3589,BETTIAH
2002,58,34,82,414,1176,1764,BHABHUA
2002,153,80,178,1035,1886,3332,BHAGALPUR
2002,188,34,86,681,2344,3333,BHOJPUR
2002,140,34,80,507,1363,2124,BUXAR
2002,151,104,186,615,2297,3353,DARBHANGA
2002,367,62,76,1091,1914,3510,GAYA
2002,158,32,84,362,1610,2246,GOPALGANJ
2002,11,0,10,263,178,462,JAMALPUR RLY.
2002,259,30,76,293,632,1290,JAMUI
2002,128,14,64,329,1013,1548,JEHANABAD
2002,92,154,174,445,1666,2531,KATIHAR
2002,14,4,6,479,244,747,KATIHAR RLY.
2002,89,30,62,200,906,1287,KHAGARIA
2002,32,40,70,229,817,1188,KISHANGANJ
2002,103,4,68,215,597,987,LAKHISARAI
2002,73,20,64,243,816,1216,MADHEPURA
2002,152,62,100,514,1817,2645,MADHUBANI
2002,144,82,278,897,3562,4963,MOTIHARI
2002,187,22,106,384,1544,2243,MUNGER
2002,222,120,334,1804,3122,5602,MUZAFFARPUR
2002,19,4,10,679,306,1018,MUZAFFARPUR RLY.
2002,366,64,186,678,2311,3605,NALANDA
2002,39,22,48,133,629,871,NAUGACHIA
2002,156,68,100,221,1147,1692,NAWADAH
2002,1154,74,406,4631,4439,10704,PATNA
2002,53,4,10,1459,284,1810,PATNA RLY.
2002,171,92,96,653,1453,2465,PURNEA
2002,167,30,184,1093,2488,3962,ROHTAS
2002,145,22,40,172,729,1108,SAHARSA
2002,239,44,112,611,2066,3072,SAMASTIPUR
2002,163,24,146,725,2634,3692,SARAN
2002,51,12,48,146,733,990,SHEIKHPURA
2002,10,28,38,57,448,581,SHEOHAR
2002,73,62,100,449,1758,2442,SITAMARHI
2002,280,16,114,506,1354,2270,SIWAN
2002,89,44,68,338,1462,2001,SUPAUL
2002,208,32,144,785,2555,3724,VAISHALI
2002,51,60,6,207,440,764,BALRAMPUR
2002,99,144,30,1743,3263,5279,BILASPUR
2002,37,14,4,56,251,362,BIZAPUR
2002,88,18,8,202,461,777,DANTEWARA
2002,28,52,8,337,1019,1444,DHAMTARI
2002,137,264,58,2197,4204,6860,DURG
2002,3,10,0,422,198,633,GRP RAIPUR
2002,104,92,38,456,1431,2121,JAGDALPUR
2002,67,84,12,564,1505,2232,JANJGIR
2002,68,70,0,250,576,964,JASHPUR
2002,24,40,4,191,692,951,KABIRDHAM
2002,41,74,12,209,875,1211,KANKER
2002,50,76,8,881,1631,2646,KORBA
2002,36,116,14,476,1107,1749,KORIYA
2002,31,66,10,453,981,1541,MAHASAMUND
2002,80,78,10,695,910,1773,RAIGARH
2002,149,318,80,1906,3833,6286,RAIPUR
2002,68,124,16,560,1951,2719,RAJNANDGAON
2002,136,284,38,1006,1626,3090,SARGUJA
2002,29,18,8,804,847,1706,NORTH GOA
2002,21,6,10,593,702,1332,SOUTH GOA
2002,365,24,306,9086,8565,18346,AHMEDABAD COMMR.
2002,87,14,26,592,2342,3061,AHMEDABAD RURAL
2002,7,8,2,30,241,288,AHWA-DANG
2002,38,8,54,402,1599,2101,AMRELI
2002,79,16,76,893,3127,4191,ANAND
2002,72,14,48,796,2477,3407,BHARUCH
2002,102,18,102,1332,3993,5547,BHAVNAGAR
2002,78,28,18,441,1381,1946,DAHOD
2002,38,14,42,1200,2598,3892,GANDHINAGAR
2002,94,22,80,844,3590,4630,HIMATNAGAR
2002,63,50,72,1242,2740,4167,JAMNAGAR
2002,77,20,100,1342,3904,5443,JUNAGADH
2002,74,18,58,878,3197,4225,KHEDA NORTH
2002,57,6,80,779,2996,3918,KUTCH
2002,92,26,82,1570,3981,5751,MEHSANA
2002,20,14,10,112,664,820,NARMADA
2002,30,10,22,393,1119,1574,NAVSARI
2002,69,32,94,865,3025,4085,PALANPUR
2002,101,8,44,860,1752,2765,PANCHMAHAL
2002,37,6,58,550,1994,2645,PATAN
2002,14,8,18,194,1084,1318,PORBANDAR
2002,68,12,80,2718,2979,5857,RAJKOT COMMR.
2002,71,30,100,977,3634,4812,RAJKOT RURAL
2002,109,36,126,3472,1778,5521,SURAT COMMR.
2002,85,20,38,531,1650,2324,SURAT RURAL
2002,70,26,74,613,2618,3401,SURENDRANAGAR
2002,103,10,70,2547,5405,8135,VADODARA COMMR.
2002,110,24,90,587,2823,3634,VADODARA RURAL
2002,53,6,42,1088,1993,3182,VALSAD
2002,28,6,18,1791,385,2228,W.RLY
2002,43,30,42,928,1494,2537,AMBALA
2002,59,34,32,576,1464,2165,BHIWANI
2002,95,74,122,1642,5695,7628,FARIDABAD
2002,37,14,44,442,902,1439,FATEHABAD
2002,26,2,0,414,627,1069,GRP
2002,116,54,100,1909,2264,4443,GURGAON
2002,101,30,48,1074,1664,2917,HISSAR
2002,66,36,28,514,1089,1733,JHAJJAR
2002,46,38,30,387,980,1481,JIND
2002,47,14,14,398,836,1309,KAITHAL
2002,67,74,32,1006,1438,2617,KARNAL
2002,44,30,36,839,1197,2146,KURUKSHETRA
2002,30,32,38,305,1097,1502,MAHENDRAGARH
2002,9,26,38,550,809,1432,PANCHKULA
2002,71,86,60,1113,1302,2632,PANIPAT
2002,30,20,22,410,1031,1513,REWARI
2002,102,34,32,979,1153,2300,ROHTAK
2002,80,40,44,655,1221,2040,SIRSA
2002,131,28,48,870,1338,2415,SONIPAT
2002,47,26,44,514,978,1609,YAMUNANAGAR
2002,26,18,16,172,1106,1338,BILASPUR
2002,17,32,28,178,549,804,CHAMBA
2002,0,0,2,3,109,114,G.R.P.
2002,14,6,28,75,841,964,HAMIRPUR
2002,50,28,40,264,1718,2100,KANGRA
2002,2,8,6,41,211,268,KINNAUR
2002,10,28,22,88,717,865,KULLU
2002,2,0,0,16,155,173,LAHAUL-SPITI
2002,14,48,18,228,1602,1910,MANDI
2002,25,54,44,360,1709,2192,SHIMLA
2002,18,22,20,94,656,810,SIRMAUR
2002,13,18,36,189,1160,1416,SOLAN
2002,18,12,16,149,741,936,UNA
2002,182,32,134,354,836,1538,ANANTNAG
2002,26,2,32,62,306,428,AWANTIPORA
2002,232,28,174,458,830,1722,BARAMULLA
2002,33,10,28,47,744,862,BORDER
2002,69,24,80,270,556,999,BUDGAM
2002,1,0,0,0,106,107,CRIME JAMMU
2002,1,0,0,0,104,105,CRIME SRINAGAR
2002,223,30,38,75,504,870,DODA
2002,27,14,78,147,386,652,GANDERBAL
2002,119,0,46,67,357,589,HANDWARA
2002,102,14,120,1048,2438,3722,JAMMU
2002,1,2,4,12,163,182,KARGIL
2002,40,22,26,142,888,1118,KATHUA
2002,45,14,90,136,472,757,KULGAM
2002,180,10,56,73,388,707,KUPWARA
2002,7,6,2,23,201,239,LEH
2002,224,18,28,103,407,780,POONCH
2002,164,24,88,351,532,1159,PULWAMA
2002,2,0,0,14,114,130,RAILWAYS
2002,201,26,26,102,886,1241,RAJOURI
2002,131,14,12,79,466,702,RAMBAN
2002,107,16,32,69,302,526,REASI
2002,136,48,234,1652,1550,3620,SRINAGAR
2002,35,30,20,282,938,1305,UDHAMPUR
2002,166,96,80,1131,1272,2745,BOKARO
2002,176,74,38,251,377,916,CHAIBASA
2002,35,36,8,235,732,1046,CHATRA
2002,70,74,10,289,1073,1516,DEOGHAR
2002,130,76,144,1282,2109,3741,DHANBAD
2002,5,4,4,541,196,750,DHANBAD RLY.
2002,216,100,30,251,578,1175,DUMKA
2002,56,64,18,204,714,1056,GARHWA
2002,99,78,46,440,1501,2164,GIRIDIH
2002,67,172,42,321,1916,2518,GODDA
2002,140,62,18,219,424,863,GUMLA
2002,145,142,66,1312,1574,3239,HAZARIBAGH
2002,261,152,100,1272,1566,3351,JAMSHEDPUR
2002,2,2,2,245,164,415,JAMSHEDPUR RLY.
2002,51,50,26,178,419,724,JAMTARA
2002,55,12,26,176,658,927,KODERMA
2002,57,24,16,122,383,602,LATEHAR
2002,53,28,4,99,382,566,LOHARDAGGA
2002,44,74,12,99,514,743,PAKUR
2002,117,28,32,380,1169,1726,PALAMU
2002,431,110,134,1955,2443,5073,RANCHI
2002,103,52,44,239,495,933,SAHEBGANJ
2002,87,52,32,297,587,1055,SARAIKELA
2002,65,32,4,44,249,394,SIMDEGA
2002,89,8,34,371,1591,2093,BAGALKOT
2002,512,64,318,16685,16708,34287,BANGALORE COMMR.
2002,267,44,76,2110,5523,8020,BANGALORE RURAL
2002,173,12,52,807,3879,4923,BELGAUM
2002,120,22,26,742,2468,3378,BELLARY
2002,111,16,46,678,3789,4640,BIDAR
2002,115,6,60,406,2329,2916,BIJAPUR
2002,53,8,12,254,1183,1510,CHAMARAJNAGAR
2002,100,36,24,645,2279,3084,CHICKMAGALUR
2002,55,24,14,461,2639,3193,CHITRADURGA
2002,53,18,12,601,2990,3674,DAKSHIN KANNADA
2002,83,28,36,785,2456,3388,DAVANAGERE
2002,53,2,32,688,1548,2323,DHARWAD COMMR.
2002,48,0,14,116,836,1014,DHARWAD RURAL
2002,37,6,8,201,819,1071,GADAG
2002,155,48,86,742,3222,4253,GULBARGA
2002,139,22,52,795,3423,4431,HASSAN
2002,37,4,20,296,1759,2116,HAVERI
2002,30,12,6,611,740,1399,K.G.F.
2002,64,8,12,301,1124,1509,KODAGU
2002,144,36,72,900,2851,4003,KOLAR
2002,56,12,52,271,1158,1549,KOPPAL
2002,117,60,36,831,4061,5105,MANDYA
2002,60,14,20,687,1303,2084,MYSORE COMMR.
2002,107,10,32,591,2315,3055,MYSORE RURAL
2002,126,12,50,436,1966,2590,RAICHUR
2002,15,0,0,784,405,1204,RAILWAYS
2002,100,22,28,956,3423,4529,SHIMOGA
2002,107,18,38,1026,3370,4559,TUMKUR
2002,37,2,18,300,1999,2356,UDUPI
2002,40,10,4,255,2161,2470,UTTAR KANNADA
2002,48,26,28,746,6807,7655,ALAPUZHA
2002,23,0,2,24,259,308,CBCID
2002,116,54,24,3113,13124,16431,ERNAKULAM
2002,50,52,0,630,4058,4790,IDUKKI
2002,91,42,28,657,4320,5138,KANNUR
2002,42,50,26,448,2412,2978,KASARGOD
2002,90,120,40,1095,8503,9848,KOLLAM
2002,42,56,30,1166,6070,7364,KOTTAYAM
2002,60,106,10,1647,7076,8899,KOZHIKODE
2002,54,140,22,870,5554,6640,MALAPPURAM
2002,93,96,20,1032,5044,6285,PALAKKAD
2002,52,24,0,587,3881,4544,PATHANAMTHITTA
2002,0,0,0,607,184,791,RAILWAYS
2002,111,60,22,1264,8471,9928,THRISSUR
2002,127,112,72,2590,9980,12881,TRIVANDRUM
2002,17,60,0,385,1712,2174,WAYANADU
2002,110,174,18,746,2191,3239,BALAGHAT
2002,71,60,8,277,1529,1945,BARWANI
2002,115,230,44,514,2230,3133,BETUL
2002,178,66,58,879,2823,4004,BHIND
2002,154,196,82,4018,11130,15580,BHOPAL
2002,12,2,0,1894,412,2320,BHOPAL RLY.
2002,136,152,50,641,2852,3831,CHHATARPUR
2002,127,164,20,604,3083,3998,CHHINDWARA
2002,106,114,28,510,2230,2988,DAMOH
2002,117,44,24,377,1514,2076,DATIYA
2002,129,194,66,2280,4739,7408,DEWAS
2002,191,148,60,1679,3910,5988,DHAR
2002,33,52,4,97,771,957,DINDORI
2002,138,296,14,1203,4870,6521,GUNA
2002,228,138,158,2893,5114,8531,GWALIOR
2002,31,56,6,192,744,1029,HARDA
2002,134,124,42,1032,2088,3420,HOSHANGABAD
2002,244,186,94,6919,10231,17674,INDORE
2002,7,2,2,335,195,541,INDORE RLY.
2002,219,160,64,2658,7056,10157,JABALPUR
2002,4,0,0,429,219,652,JABALPUR RLY.
2002,262,58,136,626,2322,3404,JHABUA
2002,77,74,6,640,1806,2603,KATNI
2002,74,142,34,1095,2938,4283,KHANDWA
2002,76,100,54,1174,2688,4092,KHARGON
2002,47,86,10,316,1494,1953,MANDLA
2002,72,90,34,1014,1992,3202,MANDSAUR
2002,178,92,54,1523,3906,5753,MORENA
2002,101,176,14,473,1855,2619,NARSINGHPUR
2002,42,52,26,807,1633,2560,NEEMUCH
2002,65,70,24,340,1387,1886,PANNA
2002,104,196,20,511,2315,3146,RAISEN
2002,93,160,22,759,3556,4590,RAJGARH
2002,83,134,20,1073,2432,3742,RATLAM
2002,108,64,72,1733,3084,5061,REWA
2002,201,272,60,1455,5603,7591,SAGAR
2002,134,132,58,1204,3329,4857,SATNA
2002,55,88,8,393,1639,2183,SEONI
2002,85,144,26,1233,3535,5023,SHAHDOL
2002,99,168,36,1700,2423,4426,SHAJAPUR
2002,56,56,40,303,1051,1506,SHEOPUR
2002,148,146,36,664,3656,4650,SHIVPURI
2002,73,92,34,1012,2755,3966,SIDHI
2002,82,126,102,1107,2892,4309,SIHORE
2002,103,102,26,595,2597,3423,TIKAMGARH
2002,226,136,94,3945,5534,9935,UJJAIN
2002,35,40,2,280,1050,1407,UMARIYA
2002,96,228,38,817,3005,4184,VIDISHA
2002,127,90,54,2161,2885,5317,AHMEDNAGAR
2002,93,56,42,1821,2630,4642,AKOLA
2002,52,36,24,1901,1471,3484,AMRAVATI COMMR.
2002,94,132,44,2559,2162,4991,AMRAVATI RURAL
2002,50,16,40,1386,1477,2969,AURANGABAD COMMR.
2002,79,24,22,760,2164,3049,AURANGABAD RURAL
2002,120,50,46,1145,2385,3746,BEED
2002,49,64,32,924,1583,2652,BHANDARA
2002,85,60,36,1779,2412,4372,BULDHANA
2002,71,58,48,1227,2018,3422,CHANDRAPUR
2002,71,32,16,826,1605,2550,DHULE
2002,84,44,18,362,1046,1554,GADCHIROLI
2002,60,50,42,872,1290,2314,GONDIA
2002,47,34,14,470,1279,1844,HINGOLI
2002,120,44,42,1621,3067,4894,JALGAON
2002,76,28,22,779,1733,2638,JALNA
2002,107,34,30,1198,2064,3433,KOLHAPUR
2002,66,8,38,684,2299,3095,LATUR
2002,386,256,238,23310,10845,35035,MUMBAI
2002,6,4,14,3419,255,3698,MUMBAI RLY.
2002,152,98,100,6549,4189,11088,NAGPUR COMMR.
2002,9,0,0,1620,314,1943,NAGPUR RLY.
2002,130,132,50,2469,3288,6069,NAGPUR RURAL
2002,168,58,80,1587,4407,6300,NANDED
2002,35,56,10,414,863,1378,NANDURBAR
2002,34,24,34,1635,1396,3123,NASIK COMMR.
2002,134,76,28,1325,3662,5225,NASIK RURAL
2002,69,48,36,2192,1468,3813,NAVI MUMBAI
2002,63,56,30,734,2089,2972,OSMANABAD
2002,86,38,22,676,1805,2627,PARBHANI
2002,137,102,72,5824,4530,10665,PUNE COMMR.
2002,4,4,2,649,170,829,PUNE RLY.
2002,178,84,32,1794,3157,5245,PUNE RURAL
2002,64,58,24,790,1523,2459,RAIGAD
2002,32,26,10,508,869,1445,RATNAGIRI
2002,126,66,44,1155,1749,3140,SANGLI
2002,100,62,28,1142,2432,3764,SATARA
2002,25,22,8,303,607,965,SINDHUDURG
2002,66,60,26,881,963,1996,SOLAPUR COMMR.
2002,119,66,56,775,2196,3212,SOLAPUR RURAL
2002,196,84,150,4349,2869,7648,THANE COMMR.
2002,163,102,70,1794,2424,4553,THANE RURAL
2002,80,74,42,1505,2381,4082,WARDHA
2002,47,58,18,863,1321,2307,WASHIM
2002,143,130,72,1901,2868,5114,YAVATMAL
2002,47,4,40,24,292,407,BISHNUPUR
2002,13,0,18,19,162,212,CHANDEL
2002,41,0,38,12,143,234,CHURACHANDPUR
2002,51,8,50,87,342,538,IMPHAL(EAST)
2002,83,6,88,344,729,1250,IMPHAL(WEST)
2002,24,0,2,14,197,237,SENAPATI
2002,6,0,8,12,116,142,TAMENGLONG
2002,56,8,68,47,438,617,THOUBAL
2002,4,2,2,12,128,148,UKHRUL
2002,23,2,10,71,134,240,GARO HILLS EAST
2002,13,2,4,30,123,172,GARO HILLS SOUTH
2002,23,10,24,117,175,349,GARO HILLS WEST
2002,43,4,6,109,212,374,JAINTIA HILLS
2002,70,38,44,631,319,1102,KHASI HILLS EAST
2002,24,14,8,51,144,241,KHASI HILLS WEST
2002,29,6,8,104,181,328,RI-BHOI
2002,23,72,8,1314,573,1990,AIZAWL
2002,7,18,0,138,192,355,CHAMPHAI
2002,5,10,2,207,196,420,KOLASIB
2002,3,4,0,58,221,286,LAWNGTLAI
2002,4,22,0,417,157,600,LUNGLEI
2002,1,8,0,53,123,185,MAMIT
2002,6,14,2,197,288,507,SAIHA
2002,6,4,2,72,118,202,SERCHHIP
2002,39,6,38,414,213,710,DIMAPUR
2002,1,2,2,9,106,120,KIPHIRE
2002,27,18,0,111,215,371,KOHIMA
2002,12,0,2,28,133,175,MOKOKCHUNG
2002,2,0,2,51,128,183,MON
2002,13,0,0,12,114,139,PEREN
2002,9,2,8,26,120,165,PHEK
2002,11,2,2,14,122,151,TUENSANG
2002,9,2,0,86,142,239,WOKHA
2002,11,2,0,22,130,165,ZUNHEBOTO
2002,83,50,30,357,1288,1808,ANGUL
2002,29,94,70,553,1990,2736,BALASORE
2002,58,24,8,334,999,1423,BARAGARH
2002,86,20,14,377,808,1305,BERHAMPUR
2002,62,54,36,192,1215,1559,BHADRAK
2002,85,30,32,278,1061,1486,BOLANGIR
2002,27,4,6,77,401,515,BOUDH
2002,187,64,76,1888,2793,5008,CUTTACK
2002,21,14,10,67,407,519,DEOGARH
2002,63,24,42,277,1042,1448,DHENKANAL
2002,16,16,8,93,414,547,GAJAPATI
2002,193,68,28,486,1532,2307,GANJAM
2002,40,34,34,410,972,1490,JAGATSINGHPUR
2002,43,36,46,410,1402,1937,JAJPUR
2002,34,22,8,173,610,847,JHARSUGUDA
2002,54,36,18,228,704,1040,KALAHANDI
2002,32,64,64,245,707,1112,KANDHAMAL
2002,71,18,34,198,784,1105,KENDRAPARA
2002,112,84,46,451,1485,2178,KEONJHAR
2002,155,104,106,2478,3287,6130,KHURDA
2002,81,60,18,440,1067,1666,KORAPUT
2002,59,30,12,141,361,603,MALKANGIR
2002,123,136,58,470,1431,2218,MAYURBHANJ
2002,89,18,28,219,697,1051,NAYAGARH
2002,41,34,36,260,558,929,NOWRANGPUR
2002,24,10,18,116,451,619,NUAPADA
2002,186,82,62,596,1958,2884,PURI
2002,51,30,24,183,789,1077,RAYAGADA
2002,52,36,20,537,852,1497,ROURKELA
2002,98,30,10,632,1355,2125,SAMBALPUR
2002,38,12,4,104,422,580,SONEPUR
2002,2,2,8,571,234,817,SRP(CUTTACK)
2002,8,0,2,334,194,538,SRP(ROURKELA)
2002,144,42,30,466,1258,1940,SUNDARGARH
2002,75,10,64,374,875,1398,AMRITSAR
2002,32,22,12,123,431,620,BARNALA
2002,64,28,28,118,489,727,BATALA
2002,64,28,64,336,763,1255,BHATINDA
2002,24,12,22,133,395,586,FARIDKOT
2002,27,0,22,127,495,671,FATEHGARH SAHIB
2002,102,54,48,438,1040,1682,FEROZEPUR
2002,13,0,2,54,443,512,G.R.P
2002,50,34,28,179,641,932,GURDASPUR
2002,69,38,32,343,919,1401,HOSHIARPUR
2002,45,26,44,187,493,795,JAGRAON
2002,123,40,100,904,1485,2652,JALANDHAR
2002,50,34,32,205,590,911,KAPURTHALA
2002,34,14,20,166,469,703,KHANNA
2002,145,80,250,1812,3783,6070,LUDHIANA
2002,62,18,28,126,611,845,MAJITHA
2002,48,20,10,125,426,629,MANSA
2002,62,8,28,191,474,763,MOGA
2002,46,16,16,129,351,558,MUKTSAR
2002,31,16,32,187,494,760,NAWAN SHAHR
2002,94,36,82,880,2259,3351,PATIALA
2002,40,12,58,359,1027,1496,ROPAR
2002,79,28,46,475,907,1535,SANGRUR
2002,82,24,34,126,476,742,TARN TARAN
2002,111,54,248,1978,5105,7496,AJMER
2002,178,88,242,2201,4802,7511,ALWAR
2002,66,148,110,397,2716,3437,BANSWARA
2002,119,102,178,1134,2550,4083,BARAN
2002,46,48,50,471,1981,2596,BARMER
2002,168,118,218,1616,5782,7902,BHARATPUR
2002,76,92,392,1913,4698,7171,BHILWARA
2002,130,48,42,862,2272,3354,BIKANER
2002,116,76,218,1020,2829,4259,BUNDI
2002,98,146,342,1747,4804,7137,CHITTORGARH
2002,74,44,62,562,2297,3039,CHURU
2002,46,32,94,855,3026,4053,DAUSA
2002,131,52,116,481,2284,3064,DHOLPUR
2002,40,42,86,261,1657,2086,DUNGARPUR
2002,7,8,6,1080,364,1465,G.R.P.
2002,157,108,120,1103,3949,5437,GANGANAGAR
2002,162,80,68,841,2834,3985,HANUMANGARH
2002,201,114,512,7066,13334,21227,JAIPUR
2002,7,6,10,381,744,1148,JAISALMER
2002,42,22,64,473,2130,2731,JALORE
2002,115,122,164,912,2545,3858,JHALAWAR
2002,69,24,98,778,3484,4453,JHUNJHUNU
2002,107,66,208,2304,4962,7647,JODHPUR
2002,36,42,116,573,2453,3220,KARAULI
2002,430,74,320,2563,4019,7406,KOTA
2002,73,78,122,1225,3649,5147,NAGAUR
2002,106,50,148,914,3992,5210,PALI
2002,40,18,120,397,2172,2747,RAJSAMAND
2002,52,42,104,680,2317,3195,SAWAI MADHOPUR
2002,70,26,104,822,3231,4253,SIKAR
2002,54,18,88,483,1816,2459,SIROHI
2002,48,36,180,702,3105,4071,TONK
2002,144,78,224,1306,5010,6762,UDAIPUR
2002,7,6,10,152,233,408,EAST
2002,1,0,2,14,130,147,NORTH
2002,4,2,2,14,162,184,SOUTH
2002,6,4,4,19,138,171,WEST
2002,224,54,62,3071,10583,13994,CHENGAI
2002,384,52,88,6263,3981,10768,CHENNAI
2002,10,0,0,642,305,957,CHENNAI RLY.
2002,137,50,60,2392,7234,9873,COIMBATORE RURAL
2002,38,4,20,2309,1950,4321,COIMBATORE URBAN
2002,184,54,84,1380,6007,7709,CUDDALORE
2002,143,40,96,1179,4885,6343,DHARMAPURI
2002,99,28,52,1293,4316,5788,DINDIGUL
2002,71,26,98,1521,5643,7359,ERODE
2002,91,40,36,1384,6965,8516,KANCHIPURAM
2002,100,20,20,897,4059,5096,KANYAKUMARI
2002,41,20,32,675,2230,2998,KARUR
2002,110,30,64,806,3799,4809,MADURAI RURAL
2002,93,14,52,1733,2532,4424,MADURAI URBAN
2002,113,54,66,772,3432,4437,NAGAPATTINAM
2002,68,26,50,489,3455,4088,NAMAKKAL
2002,36,12,6,346,1193,1593,NILGIRIS
2002,99,32,60,483,2476,3150,PERAMBALUR
2002,53,20,50,547,3019,3689,PUDUKOTTAI
2002,87,26,40,533,2764,3450,RAMNATHAPURAM
2002,120,28,52,504,4083,4787,SALEM RURAL
2002,45,16,14,795,1552,2422,SALEM URBAN
2002,86,12,32,815,2298,3243,SIVAGANGAI
2002,166,20,80,1324,2984,4574,THANJAVUR
2002,81,24,52,612,2477,3246,THENI
2002,183,82,130,1451,5369,7215,THIRUNELVELI RURAL
2002,60,6,30,452,1026,1574,THIRUNELVELI URBAN
2002,84,20,68,531,3139,3842,THIRUVALLUR
2002,74,20,88,1164,4163,5509,THIRUVANNAMALAI
2002,62,8,26,419,2239,2754,THIRUVARUR
2002,175,26,52,1226,4102,5581,THOOTHUGUDI
2002,3,0,0,161,245,409,TRICHY RLY.
2002,96,10,28,358,3079,3571,TRICHY RURAL
2002,41,4,24,1182,1862,3113,TRICHY URBAN
2002,134,62,110,2111,6737,9154,VELLORE
2002,158,102,134,1086,6335,7815,VILLUPURAM
2002,107,26,46,991,3521,4691,VIRUDHUNAGAR
2002,36,12,66,45,384,543,DHALAI
2002,38,70,32,158,582,880,NORTH
2002,40,60,32,161,579,872,SOUTH
2002,125,74,126,453,763,1541,WEST
2002,317,82,278,2517,3189,6383,AGRA
2002,394,62,224,1436,2363,4479,ALIGARH
2002,334,80,160,1574,3207,5355,ALLAHABAD
2002,93,20,70,272,729,1184,AMBEDKAR NAGAR
2002,102,20,82,211,780,1195,AURAIYA
2002,202,14,82,536,1190,2024,AZAMGARH
2002,432,62,176,704,1563,2937,BADAUN
2002,204,30,48,318,705,1305,BAGHPAT
2002,93,28,46,331,755,1253,BAHRAICH
2002,107,14,28,332,1156,1637,BALLIA
2002,40,26,26,128,423,643,BALRAMPUR
2002,117,40,46,284,1106,1593,BANDA
2002,145,64,102,675,1546,2532,BARABANKI
2002,502,130,244,1694,2466,5036,BAREILLY
2002,100,32,62,340,1055,1589,BASTI
2002,194,52,130,670,1165,2211,BIJNOR
2002,389,66,188,1000,1902,3545,BULANDSHAHAR
2002,48,12,18,218,465,761,CHANDOLI
2002,33,16,20,90,344,503,CHITRAKOOT DHAM
2002,87,10,40,261,1314,1712,DEORIA
2002,488,74,172,654,2064,3452,ETAH
2002,155,24,94,337,1072,1682,ETAWAH
2002,105,30,36,435,1235,1841,FAIZABAD
2002,158,18,74,202,1095,1547,FATEHGARH
2002,134,24,58,278,1271,1765,FATEHPUR
2002,265,52,190,576,1718,2801,FIROZABAD
2002,42,4,14,5754,1093,6907,G.R.P.
2002,140,38,72,1406,1178,2834,GAUTAMBUDH NAGAR
2002,606,40,198,2837,2089,5770,GHAZIABAD
2002,97,8,32,223,809,1169,GHAZIPUR
2002,88,22,62,443,1058,1673,GONDA
2002,186,54,86,678,1788,2792,GORAKHPUR
2002,94,18,38,195,641,986,HAMIRPUR
2002,238,78,96,381,1387,2180,HARDOI
2002,156,50,98,482,1250,2036,HATHRAS
2002,126,30,62,268,912,1398,J.P.NAGAR
2002,107,8,68,322,865,1370,JALAUN
2002,108,16,32,336,1024,1516,JAUNPUR
2002,91,28,56,453,1003,1631,JHANSI
2002,120,12,48,198,693,1071,KANNAUJ
2002,101,26,82,333,1075,1617,KANPUR DEHAT
2002,368,60,326,2699,3425,6878,KANPUR NAGAR
2002,91,56,40,223,688,1098,KAUSHAMBI
2002,283,82,120,672,1632,2789,KHIRI
2002,84,14,48,264,922,1332,KUSHI NAGAR
2002,29,20,4,129,522,704,LALITPUR
2002,337,86,390,5244,4439,10496,LUCKNOW
2002,66,26,20,111,561,784,MAHARAJGANJ
2002,49,10,14,188,456,717,MAHOBA
2002,245,18,110,401,1086,1860,MAINPURI
2002,262,32,98,901,1633,2926,MATHURA
2002,91,30,52,243,834,1250,MAU
2002,405,70,254,2031,2084,4844,MEERUT
2002,81,14,34,271,670,1070,MIRZAPUR
2002,338,72,154,1238,1549,3351,MORADABAD
2002,482,60,242,1223,1746,3753,MUZAFFARNAGAR
2002,191,82,102,475,1289,2139,PILIBHIT
2002,151,36,50,311,1462,2010,PRATAPGARH
2002,131,70,80,614,1481,2376,RAIBAREILLY
2002,164,40,80,661,790,1735,RAMPUR
2002,203,30,128,747,1499,2607,SAHARANPUR
2002,40,8,24,100,367,539,SANT KABIRNAGAR
2002,415,80,178,841,1573,3087,SHAHJAHANPUR
2002,43,6,12,165,385,611,SHRAWASTI
2002,25,12,42,131,476,686,SIDHARTHNAGAR
2002,311,146,198,1441,1963,4059,SITAPUR
2002,62,10,14,186,426,698,SONBHADRA
2002,44,0,10,176,450,680,ST.RAVIDASNAGAR
2002,194,46,68,607,1461,2376,SULTANPUR
2002,220,68,126,559,1931,2904,UNNAO
2002,165,32,104,1181,1777,3259,VARANASI
2002,31,6,4,148,277,466,ALMORA
2002,5,10,6,55,178,254,BAGESHWAR
2002,22,8,12,71,230,343,CHAMOLI
2002,10,4,8,37,153,212,CHAMPAWAT
2002,76,24,124,756,1087,2067,DEHRADUN
2002,145,46,126,1007,1151,2475,HARIDWAR
2002,66,10,26,423,514,1039,NAINITAL
2002,38,12,22,191,312,575,PAURI GARHWAL
2002,11,6,0,52,313,382,PITHORAGARH
2002,14,0,2,47,166,229,RUDRA PRAYAG
2002,18,6,10,92,275,401,TEHRI GARHWAL
2002,93,28,44,548,811,1524,UDHAMSINGH NAGAR
2002,12,18,12,72,249,363,UTTARKASHI
2002,259,176,182,3775,4379,8771,24 PARGANAS NORTH
2002,142,136,134,2194,4517,7123,24 PARGANAS SOUTH
2002,11,2,6,118,352,489,ASANSOL
2002,66,38,24,468,901,1497,BANKURA
2002,78,72,56,441,1639,2286,BIRBHUM
2002,103,106,96,1148,3273,4726,BURDWAN
2002,31,86,84,272,925,1398,COOCHBEHAR
2002,23,40,52,214,967,1296,DAKSHIN DINAJPUR
2002,63,44,46,1021,1282,2456,DARJEELING
2002,83,64,72,1012,2035,3266,HOOGHLY
2002,20,12,16,274,1182,1504,HOWRAH
2002,27,20,48,690,817,1602,HOWRAH CITY
2002,16,6,2,666,236,926,HOWRAH G.R.P.
2002,113,76,44,861,1240,2334,JALPAIGURI
2002,6,0,2,265,141,414,KHARAGPUR G.R.P.
2002,206,66,214,7864,4983,13333,KOLKATA
2002,85,66,78,594,1129,1952,MALDA
2002,128,124,74,714,1985,3025,MURSHIDABAD
2002,99,158,164,1285,2826,4532,NADIA
2002,124,106,94,725,1964,3013,PASCHIM MIDNAPUR
2002,39,50,84,351,1717,2241,PURAB MIDNAPUR
2002,41,30,28,497,833,1429,PURULIA
2002,26,0,8,514,208,756,SEALDAH G.R.P.
2002,4,0,2,182,134,322,SILIGURI G.R.P.
2002,64,40,52,495,988,1639,UTTAR DINAJPUR
2002,17,2,4,147,532,702,ANDAMAN
2002,3,2,0,8,121,134,NICOBAR
2002,66,36,108,3658,1502,5370,CHANDIGARH
2002,13,8,18,192,285,516,D and N HAVELI
2002,8,0,4,144,192,348,DAMAN
2002,3,0,2,27,133,165,DIU
2002,61,44,142,2896,1751,4894,CENTRAL
2002,85,20,282,3147,1841,5375,EAST
2002,6,0,6,2573,180,2765,G.R.P.(RLY)
2002,4,0,2,107,185,298,I.G.I. AIRPORT
2002,14,16,40,2374,941,3385,NEW DELHI
2002,62,54,168,2559,1991,4834,NORTH
2002,131,78,312,1970,1519,4010,NORTH EAST
2002,225,240,860,5210,5279,11814,NORTH WEST
2002,0,0,0,0,104,104,S.T.F.
2002,140,130,326,7681,4425,12702,SOUTH
2002,97,136,252,3482,2407,6374,SOUTH WEST
2002,1,0,0,0,119,120,SPL CELL
2002,145,88,256,4227,4393,9109,WEST
2002,0,2,0,33,134,169,LAKSHADWEEP
2002,72,12,20,1189,3687,4980,PONDICHERRY
2003,172,70,92,807,3892,5033,ADILABAD
2003,288,38,120,927,3400,4773,ANANTAPUR
2003,189,72,180,2129,4724,7294,CHITTOOR
2003,102,20,74,520,2891,3607,CUDDAPAH
2003,256,62,204,4089,6561,11172,CYBERABAD
2003,151,36,118,2914,5253,8472,EAST GODAVARI
2003,4,2,2,423,250,681,GUNTAKAL RLY.
2003,294,92,190,2706,5171,8453,GUNTUR
2003,256,114,310,15133,8908,24721,HYDERABAD CITY
2003,258,176,178,1237,5805,7654,KARIMNAGAR
2003,133,90,82,953,4131,5389,KHAMMAM
2003,131,90,110,1449,3921,5701,KRISHNA
2003,226,56,70,702,3701,4755,KURNOOL
2003,299,138,92,1212,3983,5724,MAHABOOBNAGAR
2003,160,60,104,1364,3554,5242,MEDAK
2003,210,124,98,906,4443,5781,NALGONDA
2003,150,54,126,1386,4597,6313,NELLORE
2003,139,58,70,944,3675,4886,NIZAMABAD
2003,130,44,84,863,2852,3973,PRAKASHAM
2003,95,28,46,413,1547,2129,RANGA REDDY
2003,10,0,0,835,206,1051,SECUNDERABAD RLY.
2003,71,18,16,447,2241,2793,SRIKAKULAM
2003,92,54,126,7776,4607,12655,VIJAYAWADA
2003,0,0,0,722,166,888,VIJAYAWADA RLY.
2003,66,30,30,510,2163,2799,VISAKHA RURAL
2003,40,18,60,1354,2082,3554,VISAKHAPATNAM
2003,46,12,6,383,1857,2304,VIZIANAGARAM
2003,208,122,206,1226,5293,7055,WARANGAL
2003,169,214,176,2377,5058,7994,WEST GODAVARI
2003,11,8,14,58,186,277,CHANGLANG
2003,2,4,2,49,175,232,DIBANG VALLEY
2003,5,0,4,4,119,132,K/KUMEY
2003,4,0,4,42,158,208,KAMENG EAST
2003,8,2,0,36,153,199,KAMENG WEST
2003,16,2,30,82,195,325,LOHIT
2003,11,6,20,298,278,613,PAPUM PARE
2003,8,18,20,131,212,389,SIANG EAST
2003,6,2,2,40,125,175,SIANG UPPER
2003,7,10,10,126,251,404,SIANG WEST
2003,6,6,8,63,164,247,SUBANSIRI LOWER
2003,5,2,4,46,179,236,SUBANSIRI UPPER
2003,0,0,0,41,125,166,TAWANG
2003,5,2,16,70,176,269,TIRAP
2003,3,0,2,4,114,123,UPPER DIBANG VALLEY
2003,55,122,152,389,1213,1931,BARPETA
2003,36,54,92,291,529,1002,BONGAIGAON
2003,0,0,2,0,122,124,C.I.D.
2003,103,140,240,1110,2339,3932,CACHAR
2003,94,106,166,592,752,1710,DARRANG
2003,38,86,50,235,581,990,DHEMAJI
2003,84,136,124,344,1388,2076,DHUBRI
2003,140,76,108,799,1191,2314,DIBRUGARH
2003,4,0,2,119,215,340,G.R.P.
2003,53,120,102,366,756,1397,GOALPARA
2003,71,134,146,717,841,1909,GOLAGHAT
2003,79,76,432,3048,3034,6669,GUWAHATI CITY
2003,43,54,86,244,570,997,HAILAKANDI
2003,53,80,56,457,773,1419,JORHAT
2003,42,96,102,485,858,1583,KAMRUP
2003,79,32,74,271,411,867,KARBI ANGLONG
2003,50,58,94,295,664,1161,KARIMGANJ
2003,69,44,80,212,499,904,KOKRAJHAR
2003,50,152,160,597,1100,2059,LAKHIMPUR
2003,21,70,98,242,633,1064,MORIGAON
2003,29,0,26,95,214,364,N.C.HILLS
2003,126,210,338,1245,2209,4128,NAGAON
2003,67,66,128,380,854,1495,NALBARI
2003,2,10,0,8,120,140,R.P.O.
2003,81,76,152,660,1065,2034,SIBSAGAR
2003,125,128,180,942,1416,2791,SONITPUR
2003,82,64,66,533,675,1420,TINSUKIA
2003,75,76,112,501,1622,2386,ARARIA
2003,55,6,18,99,562,740,ARWAL
2003,136,36,52,381,1978,2583,AURANGABAD
2003,53,42,80,225,733,1133,BAGAHA
2003,107,38,50,296,965,1456,BANKA
2003,198,38,192,734,2206,3368,BEGUSARAI
2003,166,54,178,500,2440,3338,BETTIAH
2003,153,22,80,449,784,1488,BHABHUA
2003,286,90,196,929,1965,3466,BHAGALPUR
2003,171,24,96,643,2131,3065,BHOJPUR
2003,234,24,52,516,634,1460,BUXAR
2003,126,154,122,505,2133,3040,DARBHANGA
2003,286,54,138,1188,2125,3791,GAYA
2003,143,24,68,262,1681,2178,GOPALGANJ
2003,10,2,8,292,164,476,JAMALPUR RLY.
2003,89,48,68,269,803,1277,JAMUI
2003,165,18,80,400,1262,1925,JEHANABAD
2003,113,184,136,585,1560,2578,KATIHAR
2003,7,0,20,549,303,879,KATIHAR RLY.
2003,132,32,154,215,1109,1642,KHAGARIA
2003,31,34,78,258,787,1188,KISHANGANJ
2003,82,14,78,160,650,984,LAKHISARAI
2003,76,16,48,184,840,1164,MADHEPURA
2003,250,76,124,537,1831,2818,MADHUBANI
2003,174,78,228,811,3294,4585,MOTIHARI
2003,108,14,94,364,1533,2113,MUNGER
2003,150,118,320,1660,3322,5570,MUZAFFARPUR
2003,28,6,12,683,278,1007,MUZAFFARPUR RLY.
2003,310,42,116,533,2180,3181,NALANDA
2003,70,24,58,127,601,880,NAUGACHIA
2003,148,26,106,242,1032,1554,NAWADAH
2003,1164,68,440,4623,4861,11156,PATNA
2003,41,4,10,1609,310,1974,PATNA RLY.
2003,173,100,104,747,1196,2320,PURNEA
2003,375,30,174,848,1817,3244,ROHTAS
2003,116,22,50,239,750,1177,SAHARSA
2003,257,40,160,945,2020,3422,SAMASTIPUR
2003,269,64,190,681,2867,4071,SARAN
2003,48,10,42,104,633,837,SHEIKHPURA
2003,31,16,22,49,406,524,SHEOHAR
2003,67,74,164,487,1936,2728,SITAMARHI
2003,246,26,124,561,1370,2327,SIWAN
2003,67,44,42,224,1023,1400,SUPAUL
2003,325,58,170,824,2430,3807,VAISHALI
2003,41,48,8,144,383,624,BALRAMPUR
2003,150,98,24,1942,3303,5517,BILASPUR
2003,61,16,4,67,238,386,BIZAPUR
2003,79,24,12,127,493,735,DANTEWARA
2003,21,64,16,344,1138,1583,DHAMTARI
2003,108,234,42,2070,4319,6773,DURG
2003,4,2,4,403,217,630,GRP RAIPUR
2003,85,142,24,411,1463,2125,JAGDALPUR
2003,53,94,16,541,1248,1952,JANJGIR
2003,51,66,6,171,548,842,JASHPUR
2003,23,48,6,190,726,993,KABIRDHAM
2003,69,58,10,157,721,1015,KANKER
2003,49,74,14,860,1987,2984,KORBA
2003,53,80,8,384,958,1483,KORIYA
2003,32,60,6,383,1138,1619,MAHASAMUND
2003,24,6,2,37,161,230,NARAYANPUR
2003,73,72,30,741,1294,2210,RAIGARH
2003,130,252,82,2149,4336,6949,RAIPUR
2003,62,120,16,537,1731,2466,RAJNANDGAON
2003,121,238,24,788,1467,2638,SARGUJA
2003,30,44,16,743,788,1621,NORTH GOA
2003,29,18,12,468,622,1149,SOUTH GOA
2003,158,36,314,12115,8491,21114,AHMEDABAD COMMR.
2003,49,6,36,631,2199,2921,AHMEDABAD RURAL
2003,7,0,0,15,187,209,AHWA-DANG
2003,30,12,56,442,1632,2172,AMRELI
2003,49,10,72,1064,2743,3938,ANAND
2003,52,10,56,1102,2023,3243,BHARUCH
2003,93,10,140,1580,3533,5356,BHAVNAGAR
2003,50,0,38,428,1224,1740,DAHOD
2003,35,0,68,1460,2488,4051,GANDHINAGAR
2003,54,12,88,906,3425,4485,HIMATNAGAR
2003,53,20,54,1029,2510,3666,JAMNAGAR
2003,72,26,94,1550,3674,5416,JUNAGADH
2003,59,22,98,910,2882,3971,KHEDA NORTH
2003,52,14,50,851,2633,3600,KUTCH
2003,68,14,114,1717,3565,5478,MEHSANA
2003,14,8,6,89,481,598,NARMADA
2003,33,4,20,373,1146,1576,NAVSARI
2003,58,40,84,946,2972,4100,PALANPUR
2003,53,22,62,843,1598,2578,PANCHMAHAL
2003,28,4,30,575,1963,2600,PATAN
2003,14,2,14,193,835,1058,PORBANDAR
2003,49,10,68,3458,2761,6346,RAJKOT COMMR.
2003,61,28,96,1167,3482,4834,RAJKOT RURAL
2003,91,50,124,3962,1799,6026,SURAT COMMR.
2003,63,22,32,525,1743,2385,SURAT RURAL
2003,39,32,64,735,2444,3314,SURENDRANAGAR
2003,66,16,72,3254,3525,6933,VADODARA COMMR.
2003,91,28,104,654,2565,3442,VADODARA RURAL
2003,38,10,26,1021,1765,2860,VALSAD
2003,13,4,8,2476,303,2804,W.RLY
2003,42,20,52,669,1357,2140,AMBALA
2003,69,30,34,580,1513,2226,BHIWANI
2003,87,72,140,1711,5804,7814,FARIDABAD
2003,34,14,30,256,765,1099,FATEHABAD
2003,25,2,0,304,645,976,GRP
2003,95,64,88,2057,2278,4582,GURGAON
2003,76,32,54,965,1525,2652,HISSAR
2003,67,18,16,365,968,1434,JHAJJAR
2003,53,34,22,354,815,1278,JIND
2003,34,30,8,487,869,1428,KAITHAL
2003,74,54,44,996,1493,2661,KARNAL
2003,45,46,22,890,1130,2133,KURUKSHETRA
2003,26,20,22,311,1036,1415,MAHENDRAGARH
2003,15,24,30,525,1053,1647,PANCHKULA
2003,68,76,32,1029,1136,2341,PANIPAT
2003,26,22,22,456,1123,1649,REWARI
2003,102,50,42,948,1034,2176,ROHTAK
2003,74,44,36,588,1038,1780,SIRSA
2003,99,30,52,725,1237,2143,SONIPAT
2003,37,24,30,481,972,1544,YAMUNANAGAR
2003,13,26,24,154,1025,1242,BILASPUR
2003,9,20,28,179,488,724,CHAMBA
2003,0,0,0,0,105,105,G.R.P.
2003,9,12,16,75,870,982,HAMIRPUR
2003,54,16,14,218,1853,2155,KANGRA
2003,4,12,8,68,188,280,KINNAUR
2003,15,32,16,105,700,868,KULLU
2003,0,4,0,4,157,165,LAHAUL-SPITI
2003,19,46,14,211,1573,1863,MANDI
2003,33,42,42,451,1617,2185,SHIMLA
2003,10,16,30,106,627,789,SIRMAUR
2003,21,22,20,236,1204,1503,SOLAN
2003,12,4,14,181,709,920,UNA
2003,148,18,162,357,864,1549,ANANTNAG
2003,11,4,26,102,332,475,AWANTIPORA
2003,187,36,180,582,1057,2042,BARAMULLA
2003,34,18,16,90,744,902,BORDER
2003,72,22,92,319,606,1111,BUDGAM
2003,1,0,0,0,105,106,CRIME JAMMU
2003,1,0,0,0,104,105,CRIME SRINAGAR
2003,182,12,38,100,555,887,DODA
2003,25,16,90,147,432,710,GANDERBAL
2003,99,4,44,93,311,551,HANDWARA
2003,97,40,114,988,2578,3817,JAMMU
2003,0,2,12,12,169,195,KARGIL
2003,44,26,40,144,948,1202,KATHUA
2003,51,10,100,109,446,716,KULGAM
2003,189,10,70,117,423,809,KUPWARA
2003,1,6,2,8,233,250,LEH
2003,224,24,24,140,481,893,POONCH
2003,150,20,96,356,572,1194,PULWAMA
2003,0,2,0,28,112,142,RAILWAYS
2003,221,56,38,146,1015,1476,RAJOURI
2003,147,20,20,51,494,732,RAMBAN
2003,85,16,12,32,251,396,REASI
2003,150,46,228,1423,1665,3512,SRINAGAR
2003,26,14,20,257,1084,1401,UDHAMPUR
2003,166,96,80,1081,1262,2685,BOKARO
2003,171,76,42,254,385,928,CHAIBASA
2003,37,28,14,230,919,1228,CHATRA
2003,95,106,16,348,1238,1803,DEOGHAR
2003,123,86,110,1447,2095,3861,DHANBAD
2003,10,0,8,323,244,585,DHANBAD RLY.
2003,199,98,38,221,610,1166,DUMKA
2003,53,46,36,218,821,1174,GARHWA
2003,92,70,62,703,1768,2695,GIRIDIH
2003,67,152,50,328,1905,2502,GODDA
2003,155,62,28,218,469,932,GUMLA
2003,123,80,72,1154,1863,3292,HAZARIBAGH
2003,161,56,74,1032,1286,2609,JAMSHEDPUR
2003,6,4,4,195,216,425,JAMSHEDPUR RLY.
2003,23,70,24,110,427,654,JAMTARA
2003,55,0,0,146,658,859,KODERMA
2003,57,20,2,223,364,666,LATEHAR
2003,53,30,14,98,391,586,LOHARDAGGA
2003,56,62,24,135,416,693,PAKUR
2003,94,26,28,278,1345,1771,PALAMU
2003,386,110,140,1975,2446,5057,RANCHI
2003,104,46,32,179,457,818,SAHEBGANJ
2003,102,62,52,383,656,1255,SARAIKELA
2003,51,38,24,102,317,532,SIMDEGA
2003,78,24,32,316,1671,2121,BAGALKOT
2003,496,68,264,16362,17228,34418,BANGALORE COMMR.
2003,213,54,68,2256,5641,8232,BANGALORE RURAL
2003,146,22,56,859,3667,4750,BELGAUM
2003,89,28,24,679,2779,3599,BELLARY
2003,94,12,44,715,3470,4335,BIDAR
2003,88,18,36,358,3936,4436,BIJAPUR
2003,41,6,4,326,963,1340,CHAMARAJNAGAR
2003,58,24,28,850,2426,3386,CHICKMAGALUR
2003,62,38,30,520,2869,3519,CHITRADURGA
2003,65,6,20,617,3082,3790,DAKSHIN KANNADA
2003,48,32,28,896,2330,3334,DAVANAGERE
2003,41,6,22,723,1317,2109,DHARWAD COMMR.
2003,39,10,0,173,820,1042,DHARWAD RURAL
2003,28,2,8,186,758,982,GADAG
2003,160,28,58,620,3525,4391,GULBARGA
2003,120,32,40,1001,3368,4561,HASSAN
2003,33,6,16,297,1635,1987,HAVERI
2003,32,10,8,338,720,1108,K.G.F.
2003,56,22,12,281,1060,1431,KODAGU
2003,121,28,64,890,2539,3642,KOLAR
2003,47,24,10,210,993,1284,KOPPAL
2003,116,26,16,816,3112,4086,MANDYA
2003,48,16,18,833,1275,2190,MYSORE COMMR.
2003,63,8,10,576,1951,2608,MYSORE RURAL
2003,63,24,32,387,1931,2437,RAICHUR
2003,16,0,4,1092,337,1449,RAILWAYS
2003,91,30,42,717,3119,3999,SHIMOGA
2003,125,28,48,1077,3135,4413,TUMKUR
2003,25,10,18,347,1949,2349,UDUPI
2003,45,0,2,243,2153,2443,UTTAR KANNADA
2003,60,20,24,583,6322,7009,ALAPUZHA
2003,23,2,8,28,238,299,CBCID
2003,49,22,22,1368,5587,7048,ERNAKULAM COMMR.
2003,63,44,24,978,7172,8281,ERNAKULAM RURAL
2003,42,28,0,506,3785,4361,IDUKKI
2003,50,26,8,567,3739,4390,KANNUR
2003,43,30,18,503,2395,2989,KASARGOD
2003,58,106,48,954,8143,9309,KOLLAM
2003,44,50,30,1060,5516,6700,KOTTAYAM
2003,28,20,14,1191,3602,4855,KOZHIKODE COMMR.
2003,25,48,12,464,3439,3988,KOZHIKODE RURAL
2003,35,84,22,843,4952,5936,MALAPPURAM
2003,93,94,24,853,4465,5529,PALAKKAD
2003,37,26,0,444,3763,4270,PATHANAMTHITTA
2003,3,0,0,320,175,498,RAILWAYS
2003,74,58,40,1424,8235,9831,THRISSUR
2003,63,34,28,1345,3870,5340,TRIVANDRUM COMMR.
2003,64,56,56,1054,6373,7603,TRIVANDRUM RURAL
2003,29,40,0,501,1794,2364,WAYANADU
2003,14,20,2,151,589,776,ANUPPUR
2003,48,66,10,333,1824,2281,ASHOK NAGAR
2003,80,122,14,514,2349,3079,BALAGHAT
2003,69,76,18,361,1899,2423,BARWANI
2003,116,274,48,621,2507,3566,BETUL
2003,162,50,56,742,2903,3913,BHIND
2003,165,186,110,4360,11367,16188,BHOPAL
2003,7,6,2,2231,429,2675,BHOPAL RLY.
2003,8,14,0,94,458,574,BURHANPUR
2003,124,112,22,534,2377,3169,CHHATARPUR
2003,79,164,28,537,2891,3699,CHHINDWARA
2003,97,98,36,393,2148,2772,DAMOH
2003,94,60,26,397,1604,2181,DATIYA
2003,142,176,68,2464,6569,9419,DEWAS
2003,173,164,54,1359,3678,5428,DHAR
2003,17,74,4,154,898,1147,DINDORI
2003,69,166,16,788,2778,3817,GUNA
2003,228,144,162,3061,5148,8743,GWALIOR
2003,23,50,2,226,685,986,HARDA
2003,102,140,20,1102,2318,3682,HOSHANGABAD
2003,222,154,122,6853,11315,18666,INDORE
2003,6,0,0,230,173,409,INDORE RLY.
2003,223,206,90,3040,7441,11000,JABALPUR
2003,4,0,6,474,238,722,JABALPUR RLY.
2003,220,72,74,606,2643,3615,JHABUA
2003,69,74,12,670,1943,2768,KATNI
2003,61,106,40,683,2111,3001,KHANDWA
2003,73,100,26,1589,2937,4725,KHARGON
2003,52,78,4,323,1783,2240,MANDLA
2003,57,90,24,1095,1883,3149,MANDSAUR
2003,122,80,64,1214,3515,4995,MORENA
2003,83,80,6,375,1726,2270,NARSINGHPUR
2003,28,62,18,874,1473,2455,NEEMUCH
2003,52,64,14,359,1305,1794,PANNA
2003,85,150,16,586,2744,3581,RAISEN
2003,79,176,18,906,3233,4412,RAJGARH
2003,91,124,28,1082,2551,3876,RATLAM
2003,103,82,72,1583,3051,4891,REWA
2003,168,242,60,1486,5248,7204,SAGAR
2003,120,118,36,1094,3503,4871,SATNA
2003,51,108,2,302,1577,2040,SEONI
2003,81,136,24,973,3185,4399,SHAHDOL
2003,82,142,26,1385,2596,4231,SHAJAPUR
2003,43,38,8,262,1061,1412,SHEOPUR
2003,126,138,94,632,2752,3742,SHIVPURI
2003,63,76,52,967,2873,4031,SIDHI
2003,64,172,12,850,2523,3621,SIHORE
2003,71,100,30,493,2194,2888,TIKAMGARH
2003,204,118,80,3035,5323,8760,UJJAIN
2003,31,40,0,267,998,1336,UMARIYA
2003,89,188,18,890,2800,3985,VIDISHA
2003,139,88,54,2006,2766,5053,AHMEDNAGAR
2003,86,58,58,1808,2614,4624,AKOLA
2003,56,52,30,2256,1579,3973,AMRAVATI COMMR.
2003,91,94,34,2189,2256,4664,AMRAVATI RURAL
2003,54,16,38,1317,1345,2770,AURANGABAD COMMR.
2003,84,28,8,731,2135,2986,AURANGABAD RURAL
2003,127,50,34,1583,2708,4502,BEED
2003,37,82,14,961,1645,2739,BHANDARA
2003,86,78,34,1744,2564,4506,BULDHANA
2003,62,72,26,1481,1958,3599,CHANDRAPUR
2003,45,14,10,528,1417,2014,DHULE
2003,86,60,34,391,1122,1693,GADCHIROLI
2003,54,50,24,831,1240,2199,GONDIA
2003,57,28,14,430,1399,1928,HINGOLI
2003,121,76,40,1221,2812,4270,JALGAON
2003,78,16,30,833,1795,2752,JALNA
2003,106,30,36,1274,2106,3552,KOLHAPUR
2003,90,42,30,722,2489,3373,LATUR
2003,357,266,300,22458,10625,34006,MUMBAI
2003,17,8,4,3216,233,3478,MUMBAI RLY.
2003,144,52,72,5348,3696,9312,NAGPUR COMMR.
2003,10,2,4,1897,293,2206,NAGPUR RLY.
2003,101,104,46,2133,3124,5508,NAGPUR RURAL
2003,161,66,48,1505,4499,6279,NANDED
2003,56,20,20,379,1000,1475,NANDURBAR
2003,47,22,28,1832,1302,3231,NASIK COMMR.
2003,156,108,40,1238,3240,4782,NASIK RURAL
2003,69,32,34,1960,1460,3555,NAVI MUMBAI
2003,54,24,14,872,1911,2875,OSMANABAD
2003,82,26,24,643,1792,2567,PARBHANI
2003,164,80,92,6464,4353,11153,PUNE COMMR.
2003,0,6,0,388,162,556,PUNE RLY.
2003,153,58,52,1690,3157,5110,PUNE RURAL
2003,72,50,38,749,1587,2496,RAIGAD
2003,34,32,10,517,891,1484,RATNAGIRI
2003,102,94,48,1215,1698,3157,SANGLI
2003,81,34,28,1282,2228,3653,SATARA
2003,18,16,16,296,634,980,SINDHUDURG
2003,37,30,30,917,997,2011,SOLAPUR COMMR.
2003,162,88,44,954,2400,3648,SOLAPUR RURAL
2003,174,102,116,4864,2821,8077,THANE COMMR.
2003,198,102,64,1679,2414,4457,THANE RURAL
2003,74,50,30,1627,2641,4422,WARDHA
2003,51,30,26,778,1440,2325,WASHIM
2003,151,100,76,1740,2871,4938,YAVATMAL
2003,64,4,20,28,262,378,BISHNUPUR
2003,23,0,6,11,154,194,CHANDEL
2003,35,0,8,35,140,218,CHURACHANDPUR
2003,57,6,36,98,417,614,IMPHAL(EAST)
2003,63,10,82,302,709,1166,IMPHAL(WEST)
2003,30,0,14,9,186,239,SENAPATI
2003,6,0,0,10,117,133,TAMENGLONG
2003,64,16,68,77,404,629,THOUBAL
2003,7,0,6,11,126,150,UKHRUL
2003,30,2,14,69,145,260,GARO HILLS EAST
2003,11,6,6,20,119,162,GARO HILLS SOUTH
2003,32,12,36,99,152,331,GARO HILLS WEST
2003,54,22,0,104,233,413,JAINTIA HILLS
2003,64,20,28,643,317,1072,KHASI HILLS EAST
2003,26,12,4,54,125,221,KHASI HILLS WEST
2003,18,6,10,108,169,311,RI-BHOI
2003,38,48,8,1697,841,2632,AIZAWL
2003,7,20,2,175,182,386,CHAMPHAI
2003,7,10,4,193,213,427,KOLASIB
2003,9,2,0,108,173,292,LAWNGTLAI
2003,8,12,0,471,153,644,LUNGLEI
2003,4,2,0,86,139,231,MAMIT
2003,7,8,2,236,303,556,SAIHA
2003,2,6,0,153,154,315,SERCHHIP
2003,17,4,24,224,155,424,DIMAPUR
2003,1,2,2,7,112,124,KIPHIRE
2003,38,10,4,145,203,400,KOHIMA
2003,11,2,20,31,161,225,MOKOKCHUNG
2003,14,4,2,62,129,211,MON
2003,4,2,8,15,110,139,PEREN
2003,12,4,12,24,126,178,PHEK
2003,10,0,0,34,125,169,TUENSANG
2003,11,0,4,86,127,228,WOKHA
2003,7,0,0,20,137,164,ZUNHEBOTO
2003,92,40,18,441,1175,1766,ANGUL
2003,71,98,80,571,1998,2818,BALASORE
2003,62,60,8,330,1048,1508,BARAGARH
2003,46,24,12,388,790,1260,BERHAMPUR
2003,62,50,42,247,1171,1572,BHADRAK
2003,72,50,8,344,1277,1751,BOLANGIR
2003,20,22,12,112,362,528,BOUDH
2003,190,64,64,1585,2541,4444,CUTTACK
2003,23,10,22,92,443,590,DEOGARH
2003,80,18,18,220,954,1290,DHENKANAL
2003,18,8,10,68,374,478,GAJAPATI
2003,142,34,18,464,1429,2087,GANJAM
2003,50,26,46,381,1030,1533,JAGATSINGHPUR
2003,46,34,44,485,1294,1903,JAJPUR
2003,31,30,16,243,793,1113,JHARSUGUDA
2003,32,36,18,238,566,890,KALAHANDI
2003,29,70,48,222,713,1082,KANDHAMAL
2003,67,20,32,250,737,1106,KENDRAPARA
2003,109,74,50,416,1539,2188,KEONJHAR
2003,174,114,94,2773,3113,6268,KHURDA
2003,68,76,46,451,1103,1744,KORAPUT
2003,47,34,10,116,373,580,MALKANGIR
2003,125,140,56,496,1603,2420,MAYURBHANJ
2003,62,30,36,265,718,1111,NAYAGARH
2003,41,52,32,195,544,864,NOWRANGPUR
2003,16,12,8,107,534,677,NUAPADA
2003,174,78,38,614,1865,2769,PURI
2003,44,28,10,184,730,996,RAYAGADA
2003,35,20,8,474,855,1392,ROURKELA
2003,77,44,20,636,1249,2026,SAMBALPUR
2003,14,8,4,116,421,563,SONEPUR
2003,9,2,6,688,234,939,SRP(CUTTACK)
2003,6,2,2,185,201,396,SRP(ROURKELA)
2003,124,42,18,365,1129,1678,SUNDARGARH
2003,80,22,76,447,872,1497,AMRITSAR
2003,39,30,24,134,469,696,BARNALA
2003,58,26,24,164,534,806,BATALA
2003,75,30,32,414,786,1337,BHATINDA
2003,20,20,14,159,408,621,FARIDKOT
2003,15,18,16,103,396,548,FATEHGARH SAHIB
2003,116,60,40,666,1222,2104,FEROZEPUR
2003,12,2,2,54,429,499,G.R.P
2003,42,30,10,93,579,754,GURDASPUR
2003,60,60,54,316,837,1327,HOSHIARPUR
2003,50,24,20,147,445,686,JAGRAON
2003,134,66,128,1045,1668,3041,JALANDHAR
2003,36,22,22,197,560,837,KAPURTHALA
2003,33,14,20,163,497,727,KHANNA
2003,130,76,170,1896,2897,5169,LUDHIANA
2003,62,24,24,146,607,863,MAJITHA
2003,39,22,14,146,434,655,MANSA
2003,54,18,28,283,545,928,MOGA
2003,41,18,12,122,388,581,MUKTSAR
2003,40,28,30,239,532,869,NAWAN SHAHR
2003,81,66,72,893,2028,3140,PATIALA
2003,38,20,38,343,1078,1517,ROPAR
2003,68,38,36,437,884,1463,SANGRUR
2003,52,26,22,138,490,728,TARN TARAN
2003,108,72,200,1895,4636,6911,AJMER
2003,214,100,162,2508,5028,8012,ALWAR
2003,61,106,108,368,2730,3373,BANSWARA
2003,115,100,132,974,2453,3774,BARAN
2003,32,32,52,514,1959,2589,BARMER
2003,183,82,210,1812,5572,7859,BHARATPUR
2003,80,84,296,1942,4192,6594,BHILWARA
2003,138,54,82,842,2639,3755,BIKANER
2003,128,84,138,930,2698,3978,BUNDI
2003,98,156,382,1690,4890,7216,CHITTORGARH
2003,63,44,58,588,2191,2944,CHURU
2003,50,34,80,912,2822,3898,DAUSA
2003,107,40,64,541,2062,2814,DHOLPUR
2003,50,30,58,178,1674,1990,DUNGARPUR
2003,13,0,6,1090,372,1481,G.R.P.
2003,202,150,102,1020,3735,5209,GANGANAGAR
2003,151,112,64,931,2771,4029,HANUMANGARH
2003,206,114,452,7348,12408,20528,JAIPUR
2003,3,6,20,275,587,891,JAISALMER
2003,43,12,72,371,2032,2530,JALORE
2003,113,100,138,838,2396,3585,JHALAWAR
2003,51,54,94,666,2994,3859,JHUNJHUNU
2003,107,68,192,2424,4591,7382,JODHPUR
2003,55,68,152,575,2662,3512,KARAULI
2003,327,70,268,2340,3736,6741,KOTA
2003,75,64,80,1078,3452,4749,NAGAUR
2003,92,54,160,899,3885,5090,PALI
2003,24,24,116,428,2246,2838,RAJSAMAND
2003,56,42,84,729,2432,3343,SAWAI MADHOPUR
2003,53,30,82,735,2843,3743,SIKAR
2003,56,22,70,405,1674,2227,SIROHI
2003,47,22,120,740,3164,4093,TONK
2003,138,70,182,1130,4794,6314,UDAIPUR
2003,11,10,0,118,262,401,EAST
2003,1,4,0,7,110,122,NORTH
2003,4,2,0,47,154,207,SOUTH
2003,5,4,0,11,137,157,WEST
2003,159,34,78,2866,9061,12198,CHENGAI
2003,350,76,68,8287,3014,11795,CHENNAI
2003,1,0,0,415,453,869,CHENNAI RLY.
2003,133,32,38,2599,7551,10353,COIMBATORE RURAL
2003,39,8,12,2191,1930,4180,COIMBATORE URBAN
2003,149,38,42,1133,5283,6645,CUDDALORE
2003,148,46,82,842,5333,6451,DHARMAPURI
2003,97,36,46,1078,4262,5519,DINDIGUL
2003,71,22,92,1571,5026,6782,ERODE
2003,110,62,32,1079,4338,5621,KANCHIPURAM
2003,74,22,18,663,3001,3778,KANYAKUMARI
2003,40,6,26,660,2079,2811,KARUR
2003,121,44,62,953,3343,4523,MADURAI RURAL
2003,66,14,48,1036,2542,3706,MADURAI URBAN
2003,98,10,48,607,3198,3961,NAGAPATTINAM
2003,55,14,44,579,3182,3874,NAMAKKAL
2003,35,18,6,384,1364,1807,NILGIRIS
2003,87,26,72,467,2056,2708,PERAMBALUR
2003,53,16,42,445,2944,3500,PUDUKOTTAI
2003,49,20,30,498,2631,3228,RAMNATHAPURAM
2003,201,70,138,879,5362,6650,SALEM RURAL
2003,33,22,18,732,1689,2494,SALEM URBAN
2003,57,8,50,532,2381,3028,SIVAGANGAI
2003,138,28,106,1065,3150,4487,THANJAVUR
2003,82,12,14,577,2622,3307,THENI
2003,130,86,60,1038,5505,6819,THIRUNELVELI RURAL
2003,50,8,20,297,901,1276,THIRUNELVELI URBAN
2003,72,28,46,640,2713,3499,THIRUVALLUR
2003,55,50,52,864,3366,4387,THIRUVANNAMALAI
2003,52,18,22,564,2401,3057,THIRUVARUR
2003,180,42,70,1277,4341,5910,THOOTHUGUDI
2003,0,0,0,97,228,325,TRICHY RLY.
2003,83,14,18,529,2705,3349,TRICHY RURAL
2003,28,12,28,966,1952,2986,TRICHY URBAN
2003,117,40,84,1366,6409,8016,VELLORE
2003,131,78,104,999,5887,7199,VILLUPURAM
2003,90,54,42,1152,3985,5323,VIRUDHUNAGAR
2003,62,10,72,60,472,676,DHALAI
2003,55,72,70,170,537,904,NORTH
2003,58,74,36,167,708,1043,SOUTH
2003,166,72,114,427,909,1688,WEST
2003,242,54,198,1734,1866,4094,AGRA
2003,323,48,184,1101,1146,2802,ALIGARH
2003,216,42,114,935,1535,2842,ALLAHABAD
2003,34,14,30,153,311,542,AMBEDKAR NAGAR
2003,48,8,48,114,620,838,AURAIYA
2003,151,12,52,388,923,1526,AZAMGARH
2003,319,62,146,485,1086,2098,BADAUN
2003,114,24,34,225,471,868,BAGHPAT
2003,62,10,24,158,987,1241,BAHRAICH
2003,68,4,10,212,493,787,BALLIA
2003,19,6,14,69,259,367,BALRAMPUR
2003,72,20,20,131,580,823,BANDA
2003,88,24,52,338,699,1201,BARABANKI
2003,316,64,140,833,1533,2886,BAREILLY
2003,78,10,22,214,1038,1362,BASTI
2003,116,40,66,384,1469,2075,BIJNOR
2003,242,26,72,749,1125,2214,BULANDSHAHAR
2003,46,6,10,128,325,515,CHANDOLI
2003,37,20,26,48,291,422,CHITRAKOOT DHAM
2003,77,6,28,193,663,967,DEORIA
2003,278,36,110,363,970,1757,ETAH
2003,88,4,60,248,555,955,ETAWAH
2003,57,20,22,162,565,826,FAIZABAD
2003,114,14,34,183,638,983,FATEHGARH
2003,104,6,40,172,697,1019,FATEHPUR
2003,184,24,126,462,1160,1956,FIROZABAD
2003,31,6,6,5039,722,5804,G.R.P.
2003,110,20,54,919,462,1565,GAUTAMBUDH NAGAR
2003,286,30,146,2041,1017,3520,GHAZIABAD
2003,85,4,16,188,505,798,GHAZIPUR
2003,43,10,20,172,794,1039,GONDA
2003,146,26,74,610,1026,1882,GORAKHPUR
2003,49,20,14,97,290,470,HAMIRPUR
2003,173,48,76,335,974,1606,HARDOI
2003,128,42,76,398,935,1579,HATHRAS
2003,90,12,40,249,837,1228,J.P.NAGAR
2003,91,12,46,174,563,886,JALAUN
2003,65,8,32,281,845,1231,JAUNPUR
2003,77,8,40,334,1253,1712,JHANSI
2003,102,8,58,142,680,990,KANNAUJ
2003,59,12,52,260,1013,1396,KANPUR DEHAT
2003,294,48,168,1907,1590,4007,KANPUR NAGAR
2003,75,34,16,131,382,638,KAUSHAMBI
2003,188,56,96,476,1514,2330,KHIRI
2003,54,10,36,184,567,851,KUSHI NAGAR
2003,17,10,10,58,364,459,LALITPUR
2003,276,76,236,4053,3613,8254,LUCKNOW
2003,44,8,26,101,582,761,MAHARAJGANJ
2003,51,4,14,101,324,494,MAHOBA
2003,193,14,60,259,693,1219,MAINPURI
2003,197,32,72,697,845,1843,MATHURA
2003,93,10,22,232,504,861,MAU
2003,332,80,170,1597,1216,3395,MEERUT
2003,58,12,22,198,401,691,MIRZAPUR
2003,242,86,126,797,1119,2370,MORADABAD
2003,293,64,148,858,1545,2908,MUZAFFARNAGAR
2003,125,42,72,318,854,1411,PILIBHIT
2003,83,18,44,217,739,1101,PRATAPGARH
2003,117,40,54,395,1049,1655,RAIBAREILLY
2003,112,26,48,319,823,1328,RAMPUR
2003,181,34,126,550,923,1814,SAHARANPUR
2003,31,0,10,64,372,477,SANT KABIRNAGAR
2003,280,34,130,417,844,1705,SHAHJAHANPUR
2003,21,6,8,56,249,340,SHRAWASTI
2003,24,4,14,80,623,745,SIDHARTHNAGAR
2003,193,94,116,676,1173,2252,SITAPUR
2003,33,10,12,106,295,456,SONBHADRA
2003,27,4,4,123,258,416,ST.RAVIDASNAGAR
2003,118,36,44,413,830,1441,SULTANPUR
2003,175,46,44,340,1468,2073,UNNAO
2003,122,14,36,875,1033,2080,VARANASI
2003,20,2,2,127,227,378,ALMORA
2003,15,8,0,42,157,222,BAGESHWAR
2003,18,8,6,65,219,316,CHAMOLI
2003,13,2,6,41,172,234,CHAMPAWAT
2003,74,32,60,770,987,1923,DEHRADUN
2003,120,62,96,899,1017,2194,HARIDWAR
2003,61,18,32,481,548,1140,NAINITAL
2003,30,14,28,191,350,613,PAURI GARHWAL
2003,14,6,4,83,311,418,PITHORAGARH
2003,12,4,6,36,192,250,RUDRA PRAYAG
2003,32,12,8,94,290,436,TEHRI GARHWAL
2003,87,28,80,569,944,1708,UDHAMSINGH NAGAR
2003,8,18,14,84,281,405,UTTARKASHI
2003,223,184,238,4107,4631,9383,24 PARGANAS NORTH
2003,130,178,162,2113,5050,7633,24 PARGANAS SOUTH
2003,33,16,22,242,1167,1480,ASANSOL
2003,54,86,22,526,988,1676,BANKURA
2003,64,96,70,521,1415,2166,BIRBHUM
2003,107,122,66,887,2467,3649,BURDWAN
2003,32,106,80,291,921,1430,COOCHBEHAR
2003,34,62,64,214,691,1065,DAKSHIN DINAJPUR
2003,54,48,52,1010,1123,2287,DARJEELING
2003,91,78,68,1339,2112,3688,HOOGHLY
2003,31,18,22,261,951,1283,HOWRAH
2003,23,12,24,667,984,1710,HOWRAH CITY
2003,14,0,6,635,202,857,HOWRAH G.R.P.
2003,140,120,58,1006,1487,2811,JALPAIGURI
2003,3,0,0,230,142,375,KHARAGPUR G.R.P.
2003,175,72,216,7778,4995,13236,KOLKATA
2003,97,114,48,543,1271,2073,MALDA
2003,132,212,182,874,2566,3966,MURSHIDABAD
2003,93,216,118,1403,2516,4346,NADIA
2003,135,100,90,854,2214,3393,PASCHIM MIDNAPUR
2003,43,66,104,342,1720,2275,PURAB MIDNAPUR
2003,46,50,32,341,830,1299,PURULIA
2003,25,0,6,439,170,640,SEALDAH G.R.P.
2003,6,0,4,182,148,340,SILIGURI G.R.P.
2003,40,48,50,461,1048,1647,UTTAR DINAJPUR
2003,20,4,4,180,545,753,ANDAMAN
2003,5,0,0,5,127,137,NICOBAR
2003,36,36,64,2696,1112,3944,CHANDIGARH
2003,16,2,14,173,281,486,D and N HAVELI
2003,9,8,2,130,226,375,DAMAN
2003,0,2,0,8,125,135,DIU
2003,49,40,126,2496,1437,4148,CENTRAL
2003,82,74,316,3751,1923,6146,EAST
2003,12,0,12,2046,191,2261,G.R.P.(RLY)
2003,4,0,4,152,191,351,I.G.I. AIRPORT
2003,12,16,48,1803,1013,2892,NEW DELHI
2003,55,68,126,1973,2073,4295,NORTH
2003,118,106,364,1803,1701,4092,NORTH EAST
2003,207,256,602,4889,5224,11178,NORTH WEST
2003,2,0,0,5,122,129,S.T.F.
2003,138,166,268,7062,3906,11540,SOUTH
2003,90,114,236,3227,2926,6593,SOUTH WEST
2003,123,140,210,4355,4325,9153,WEST
2003,0,4,0,22,118,144,LAKSHADWEEP
2003,61,4,36,1273,3734,5108,PONDICHERRY
2004,196,100,96,702,4043,5137,ADILABAD
2004,231,40,102,1135,3061,4569,ANANTAPUR
2004,157,56,138,2472,4983,7806,CHITTOOR
2004,154,28,78,669,3356,4285,CUDDAPAH
2004,219,80,138,4390,6204,11031,CYBERABAD
2004,197,62,94,2624,5602,8579,EAST GODAVARI
2004,9,0,0,356,251,616,GUNTAKAL RLY.
2004,259,92,176,3348,5751,9626,GUNTUR
2004,256,112,272,12913,8929,22482,HYDERABAD CITY
2004,216,170,248,1348,6041,8023,KARIMNAGAR
2004,160,86,140,1235,4623,6244,KHAMMAM
2004,117,66,56,1678,3996,5913,KRISHNA
2004,208,58,92,855,4178,5391,KURNOOL
2004,270,112,126,1299,3106,4913,MAHABOOBNAGAR
2004,163,104,98,1296,3570,5231,MEDAK
2004,177,92,144,1037,4795,6245,NALGONDA
2004,342,214,144,2256,4730,7686,NELLORE
2004,150,48,112,1112,3631,5053,NIZAMABAD
2004,196,38,88,784,2966,4072,PRAKASHAM
2004,112,50,52,591,1694,2499,RANGA REDDY
2004,12,0,0,735,186,933,SECUNDERABAD RLY.
2004,56,30,30,505,2355,2976,SRIKAKULAM
2004,89,38,152,5132,4028,9439,VIJAYAWADA
2004,2,0,0,577,160,739,VIJAYAWADA RLY.
2004,68,36,24,455,2509,3092,VISAKHA RURAL
2004,54,24,54,1812,1745,3689,VISAKHAPATNAM
2004,59,28,16,510,2040,2653,VIZIANAGARAM
2004,178,106,250,1732,5759,8025,WARANGAL
2004,180,162,132,2852,4811,8137,WEST GODAVARI
2004,11,18,14,79,185,307,CHANGLANG
2004,11,6,6,43,165,231,DIBANG VALLEY
2004,5,0,2,10,127,144,K/KUMEY
2004,5,0,4,40,162,211,KAMENG EAST
2004,3,4,8,58,161,234,KAMENG WEST
2004,12,10,14,68,201,305,LOHIT
2004,11,8,16,328,298,661,PAPUM PARE
2004,3,22,28,111,278,442,SIANG EAST
2004,5,2,0,29,127,163,SIANG UPPER
2004,11,12,20,124,311,478,SIANG WEST
2004,10,0,2,31,161,204,SUBANSIRI LOWER
2004,16,0,8,54,182,260,SUBANSIRI UPPER
2004,2,0,0,28,147,177,TAWANG
2004,4,2,8,59,177,250,TIRAP
2004,3,0,0,6,113,122,UPPER DIBANG VALLEY
2004,54,100,148,611,1015,1928,BARPETA
2004,38,82,104,345,865,1434,BONGAIGAON
2004,0,0,0,0,121,121,C.I.D.
2004,76,92,224,1107,2448,3947,CACHAR
2004,85,110,118,718,1006,2037,DARRANG
2004,34,106,106,286,578,1110,DHEMAJI
2004,68,158,150,374,1577,2327,DHUBRI
2004,144,116,176,830,1309,2575,DIBRUGARH
2004,17,4,6,360,208,595,G.R.P.
2004,35,100,106,293,784,1318,GOALPARA
2004,82,124,182,760,836,1984,GOLAGHAT
2004,60,176,590,2369,2916,6111,GUWAHATI CITY
2004,43,36,64,163,674,980,HAILAKANDI
2004,46,64,68,376,658,1212,JORHAT
2004,28,118,386,842,1680,3054,KAMRUP
2004,62,28,40,258,431,819,KARBI ANGLONG
2004,69,64,72,267,867,1339,KARIMGANJ
2004,84,66,62,284,566,1062,KOKRAJHAR
2004,51,112,194,607,961,1925,LAKHIMPUR
2004,19,72,86,200,641,1018,MORIGAON
2004,16,2,18,115,224,375,N.C.HILLS
2004,123,182,278,1199,2289,4071,NAGAON
2004,61,58,122,366,769,1376,NALBARI
2004,6,10,0,52,170,238,R.P.O.
2004,67,98,162,557,1019,1903,SIBSAGAR
2004,117,174,216,1021,1653,3181,SONITPUR
2004,139,90,134,812,814,1989,TINSUKIA
2004,125,68,168,511,1421,2293,ARARIA
2004,44,4,18,146,438,650,ARWAL
2004,77,36,62,595,1992,2762,AURANGABAD
2004,141,46,176,178,658,1199,BAGAHA
2004,83,88,80,335,1037,1623,BANKA
2004,210,46,246,820,2201,3523,BEGUSARAI
2004,170,256,452,735,3898,5511,BETTIAH
2004,73,40,94,419,1025,1651,BHABHUA
2004,221,126,190,1019,2265,3821,BHAGALPUR
2004,319,18,60,770,2953,4120,BHOJPUR
2004,135,26,102,637,1668,2568,BUXAR
2004,75,118,120,391,2557,3261,DARBHANGA
2004,341,38,140,1328,2241,4088,GAYA
2004,209,78,156,487,2020,2950,GOPALGANJ
2004,16,0,2,376,200,594,JAMALPUR RLY.
2004,153,62,142,250,982,1589,JAMUI
2004,118,12,76,379,1052,1637,JEHANABAD
2004,93,158,142,428,1393,2214,KATIHAR
2004,10,4,10,484,254,762,KATIHAR RLY.
2004,138,36,86,318,1222,1800,KHAGARIA
2004,38,64,160,300,743,1305,KISHANGANJ
2004,150,26,100,209,625,1110,LAKHISARAI
2004,81,22,46,211,985,1345,MADHEPURA
2004,151,122,138,615,2005,3031,MADHUBANI
2004,189,58,258,988,3240,4733,MOTIHARI
2004,94,22,86,408,1324,1934,MUNGER
2004,197,332,600,1961,4616,7706,MUZAFFARPUR
2004,23,4,20,822,290,1159,MUZAFFARPUR RLY.
2004,359,86,288,947,2240,3920,NALANDA
2004,87,14,54,196,902,1253,NAUGACHIA
2004,179,74,134,266,1338,1991,NAWADAH
2004,730,92,540,4629,6068,12059,PATNA
2004,35,4,10,1564,331,1944,PATNA RLY.
2004,169,124,152,786,1503,2734,PURNEA
2004,345,24,88,709,1987,3153,ROHTAS
2004,148,42,94,337,1128,1749,SAHARSA
2004,263,56,246,776,2226,3567,SAMASTIPUR
2004,204,34,318,810,3819,5185,SARAN
2004,84,6,40,132,659,921,SHEIKHPURA
2004,40,26,16,69,352,503,SHEOHAR
2004,106,140,224,593,2054,3117,SITAMARHI
2004,182,14,208,609,1574,2587,SIWAN
2004,87,50,50,372,1488,2047,SUPAUL
2004,251,84,434,936,3694,5399,VAISHALI
2004,53,54,12,115,372,606,BALRAMPUR
2004,136,122,42,2031,3648,5979,BILASPUR
2004,83,6,2,42,232,365,BIZAPUR
2004,121,22,16,189,534,882,DANTEWARA
2004,26,74,10,268,1037,1415,DHAMTARI
2004,113,248,82,2254,4558,7255,DURG
2004,7,4,4,459,200,674,GRP RAIPUR
2004,96,164,40,579,1615,2494,JAGDALPUR
2004,94,60,16,780,1720,2670,JANJGIR
2004,60,112,8,237,574,991,JASHPUR
2004,26,44,14,305,892,1281,KABIRDHAM
2004,93,44,24,232,730,1123,KANKER
2004,61,68,12,823,1628,2592,KORBA
2004,51,100,8,452,1039,1650,KORIYA
2004,33,70,6,461,1147,1717,MAHASAMUND
2004,47,2,2,57,175,283,NARAYANPUR
2004,80,90,34,883,1319,2406,RAIGARH
2004,143,286,62,2461,4871,7823,RAIPUR
2004,65,122,8,626,1836,2657,RAJNANDGAON
2004,158,246,26,971,1729,3130,SARGUJA
2004,26,26,6,758,752,1568,NORTH GOA
2004,20,48,20,532,562,1182,SOUTH GOA
2004,154,80,430,12661,9622,22947,AHMEDABAD COMMR.
2004,33,24,64,637,2383,3141,AHMEDABAD RURAL
2004,4,4,0,14,205,227,AHWA-DANG
2004,42,10,52,449,1909,2462,AMRELI
2004,33,24,82,899,2579,3617,ANAND
2004,45,28,42,902,2104,3121,BHARUCH
2004,74,44,142,1862,3882,6004,BHAVNAGAR
2004,54,18,56,497,1377,2002,DAHOD
2004,39,16,30,1000,2137,3222,GANDHINAGAR
2004,55,20,94,628,3382,4179,HIMATNAGAR
2004,55,16,64,948,3133,4216,JAMNAGAR
2004,71,18,114,1267,3757,5227,JUNAGADH
2004,62,16,48,944,2965,4035,KHEDA NORTH
2004,48,26,74,1056,2821,4025,KUTCH
2004,66,8,108,1536,3452,5170,MEHSANA
2004,18,12,16,84,591,721,NARMADA
2004,28,10,14,384,976,1412,NAVSARI
2004,59,42,74,893,2860,3928,PALANPUR
2004,64,14,56,946,1627,2707,PANCHMAHAL
2004,35,12,58,554,1812,2471,PATAN
2004,20,2,14,200,882,1118,PORBANDAR
2004,53,18,78,2796,2654,5599,RAJKOT COMMR.
2004,58,34,82,943,3423,4540,RAJKOT RURAL
2004,82,48,144,3496,1892,5662,SURAT COMMR.
2004,59,28,26,434,2295,2842,SURAT RURAL
2004,50,26,54,696,2294,3120,SURENDRANAGAR
2004,61,12,88,3370,3222,6753,VADODARA COMMR.
2004,94,44,112,725,2502,3477,VADODARA RURAL
2004,49,18,44,971,1872,2954,VALSAD
2004,17,6,6,2649,913,3591,W.RLY
2004,38,20,44,705,1641,2448,AMBALA
2004,77,56,38,835,1499,2505,BHIWANI
2004,98,84,132,1902,4220,6436,FARIDABAD
2004,41,18,34,304,844,1241,FATEHABAD
2004,31,4,6,365,809,1215,GRP
2004,106,72,110,2444,2469,5201,GURGAON
2004,101,32,86,1081,1594,2894,HISSAR
2004,69,22,22,426,995,1534,JHAJJAR
2004,44,14,18,361,761,1198,JIND
2004,41,36,26,499,862,1464,KAITHAL
2004,68,62,30,959,1623,2742,KARNAL
2004,38,42,22,1051,1243,2396,KURUKSHETRA
2004,26,40,26,294,1046,1432,MAHENDRAGARH
2004,11,12,12,498,824,1357,PANCHKULA
2004,59,76,38,1028,1131,2332,PANIPAT
2004,31,32,48,556,1192,1859,REWARI
2004,104,58,38,970,1116,2286,ROHTAK
2004,54,34,32,665,1053,1838,SIRSA
2004,101,26,50,948,1366,2491,SONIPAT
2004,36,32,34,452,1029,1583,YAMUNANAGAR
2004,20,20,16,155,1023,1234,BILASPUR
2004,13,28,44,188,487,760,CHAMBA
2004,0,0,0,4,110,114,G.R.P.
2004,17,10,20,121,886,1054,HAMIRPUR
2004,33,30,30,260,1849,2202,KANGRA
2004,4,16,6,58,223,307,KINNAUR
2004,13,26,26,137,734,936,KULLU
2004,2,0,0,3,149,154,LAHAUL-SPITI
2004,26,30,14,225,1536,1831,MANDI
2004,20,68,32,453,1608,2181,SHIMLA
2004,12,18,26,93,653,802,SIRMAUR
2004,11,40,18,229,1213,1511,SOLAN
2004,16,20,14,152,742,944,UNA
2004,179,34,120,372,921,1626,ANANTNAG
2004,21,16,24,107,338,506,AWANTIPORA
2004,169,30,174,539,1114,2026,BARAMULLA
2004,19,8,22,52,731,832,BORDER
2004,98,12,122,362,616,1210,BUDGAM
2004,0,0,0,0,104,104,CRIME JAMMU
2004,0,0,0,0,104,104,CRIME SRINAGAR
2004,166,8,40,101,563,878,DODA
2004,22,24,68,183,426,723,GANDERBAL
2004,63,14,68,97,322,564,HANDWARA
2004,89,38,108,1039,2787,4061,JAMMU
2004,3,2,2,8,187,202,KARGIL
2004,47,20,48,127,877,1119,KATHUA
2004,52,22,84,102,467,727,KULGAM
2004,115,40,92,168,480,895,KUPWARA
2004,2,6,8,23,224,263,LEH
2004,201,22,36,91,397,747,POONCH
2004,151,0,94,283,591,1119,PULWAMA
2004,1,2,0,18,109,130,RAILWAYS
2004,150,44,68,239,906,1407,RAJOURI
2004,105,14,24,99,502,744,RAMBAN
2004,71,10,22,41,268,412,REASI
2004,175,48,230,1134,1587,3174,SRINAGAR
2004,29,22,16,270,1131,1468,UDHAMPUR
2004,166,96,80,1131,1272,2745,BOKARO
2004,176,74,38,251,377,916,CHAIBASA
2004,35,36,8,235,732,1046,CHATRA
2004,70,74,10,289,1073,1516,DEOGHAR
2004,130,76,144,1282,2109,3741,DHANBAD
2004,5,4,4,541,196,750,DHANBAD RLY.
2004,216,100,30,251,578,1175,DUMKA
2004,56,64,18,204,714,1056,GARHWA
2004,99,78,46,440,1501,2164,GIRIDIH
2004,67,172,42,321,1916,2518,GODDA
2004,140,62,18,219,424,863,GUMLA
2004,145,142,66,1312,1574,3239,HAZARIBAGH
2004,261,152,100,1272,1566,3351,JAMSHEDPUR
2004,2,2,2,245,164,415,JAMSHEDPUR RLY.
2004,51,50,26,178,419,724,JAMTARA
2004,55,12,26,176,658,927,KODERMA
2004,57,24,16,122,383,602,LATEHAR
2004,53,28,4,99,382,566,LOHARDAGGA
2004,44,74,12,99,514,743,PAKUR
2004,117,28,32,380,1169,1726,PALAMU
2004,431,110,134,1955,2443,5073,RANCHI
2004,103,52,44,239,495,933,SAHEBGANJ
2004,87,52,32,297,587,1055,SARAIKELA
2004,65,32,4,44,249,394,SIMDEGA
2004,77,6,48,387,1709,2227,BAGALKOT
2004,499,64,350,18921,15412,35246,BANGALORE COMMR.
2004,240,58,84,2674,5972,9028,BANGALORE RURAL
2004,187,10,52,815,3803,4867,BELGAUM
2004,73,10,34,725,3341,4183,BELLARY
2004,134,16,50,677,3479,4356,BIDAR
2004,115,16,42,388,2668,3229,BIJAPUR
2004,39,14,18,409,1346,1826,CHAMARAJNAGAR
2004,66,14,26,634,2347,3087,CHICKMAGALUR
2004,64,32,14,639,3203,3952,CHITRADURGA
2004,49,24,26,794,3524,4417,DAKSHIN KANNADA
2004,52,16,20,715,2407,3210,DAVANAGERE
2004,34,2,20,611,1235,1902,DHARWAD COMMR.
2004,41,6,6,190,840,1083,DHARWAD RURAL
2004,33,2,10,192,837,1074,GADAG
2004,235,46,80,748,3792,4901,GULBARGA
2004,118,32,38,1120,3439,4747,HASSAN
2004,36,18,14,301,1782,2151,HAVERI
2004,27,4,16,253,714,1014,K.G.F.
2004,43,16,6,372,1211,1648,KODAGU
2004,100,32,56,905,2465,3558,KOLAR
2004,34,16,8,181,984,1223,KOPPAL
2004,108,30,16,793,2790,3737,MANDYA
2004,53,8,14,1170,1456,2701,MYSORE COMMR.
2004,63,22,22,637,2108,2852,MYSORE RURAL
2004,77,12,22,328,1995,2434,RAICHUR
2004,22,0,8,1298,295,1623,RAILWAYS
2004,88,22,44,846,3088,4088,SHIMOGA
2004,121,30,16,1278,3313,4758,TUMKUR
2004,38,0,16,338,2011,2403,UDUPI
2004,40,4,8,250,2139,2441,UTTAR KANNADA
2004,33,24,22,573,6408,7060,ALAPUZHA
2004,26,0,0,57,177,260,CBCID
2004,34,14,36,1343,5477,6904,ERNAKULAM COMMR.
2004,55,42,20,928,7904,8949,ERNAKULAM RURAL
2004,47,30,20,565,3692,4354,IDUKKI
2004,44,66,8,573,4030,4721,KANNUR
2004,33,58,8,534,2179,2812,KASARGOD
2004,72,110,40,1090,8001,9313,KOLLAM
2004,25,56,26,1024,6691,7822,KOTTAYAM
2004,28,26,30,1066,3179,4329,KOZHIKODE COMMR.
2004,31,60,20,639,3516,4266,KOZHIKODE RURAL
2004,48,114,20,1078,5555,6815,MALAPPURAM
2004,79,72,26,900,4600,5677,PALAKKAD
2004,34,36,38,519,3778,4405,PATHANAMTHITTA
2004,3,0,2,252,149,406,RAILWAYS
2004,93,82,44,1571,8339,10129,THRISSUR
2004,42,36,42,1433,4135,5688,TRIVANDRUM COMMR.
2004,63,84,56,1219,7278,8700,TRIVANDRUM RURAL
2004,18,50,6,479,1966,2519,WAYANADU
2004,28,56,8,379,1177,1648,ANUPPUR
2004,50,70,6,426,1593,2145,ASHOK NAGAR
2004,96,172,20,596,2378,3262,BALAGHAT
2004,60,60,2,525,1855,2502,BARWANI
2004,102,220,34,521,2393,3270,BETUL
2004,183,58,66,797,3009,4113,BHIND
2004,162,168,86,5282,11968,17666,BHOPAL
2004,11,2,2,2624,414,3053,BHOPAL RLY.
2004,40,36,4,344,1281,1705,BURHANPUR
2004,100,124,38,697,2773,3732,CHHATARPUR
2004,94,264,30,770,3251,4409,CHHINDWARA
2004,107,108,18,506,2072,2811,DAMOH
2004,114,50,36,452,1652,2304,DATIYA
2004,141,164,60,2108,5539,8012,DEWAS
2004,178,218,60,1363,3808,5627,DHAR
2004,27,68,6,126,703,930,DINDORI
2004,77,156,12,812,2640,3697,GUNA
2004,231,116,104,3705,5538,9694,GWALIOR
2004,32,62,6,288,894,1282,HARDA
2004,113,102,40,1044,2469,3768,HOSHANGABAD
2004,243,194,94,6193,10963,17687,INDORE
2004,3,2,0,306,222,533,INDORE RLY.
2004,262,204,78,2783,7117,10444,JABALPUR
2004,7,14,0,600,286,907,JABALPUR RLY.
2004,226,44,86,470,2012,2838,JHABUA
2004,51,60,8,562,1998,2679,KATNI
2004,74,114,28,894,2919,4029,KHANDWA
2004,71,126,36,1804,3026,5063,KHARGON
2004,33,88,8,226,1722,2077,MANDLA
2004,62,80,34,1244,2077,3497,MANDSAUR
2004,210,110,30,1016,4030,5396,MORENA
2004,82,84,8,390,1924,2488,NARSINGHPUR
2004,41,46,12,858,1576,2533,NEEMUCH
2004,78,68,20,296,1083,1545,PANNA
2004,99,134,22,543,2729,3527,RAISEN
2004,75,196,38,1252,4006,5567,RAJGARH
2004,77,142,38,949,2875,4081,RATLAM
2004,93,104,72,1759,2978,5006,REWA
2004,158,282,60,1286,5711,7497,SAGAR
2004,125,128,34,1287,3677,5251,SATNA
2004,45,148,20,356,1868,2437,SEONI
2004,54,94,20,706,1888,2762,SHAHDOL
2004,93,148,30,1625,2715,4611,SHAJAPUR
2004,26,42,10,240,898,1216,SHEOPUR
2004,127,122,56,847,3041,4193,SHIVPURI
2004,80,102,54,914,2817,3967,SIDHI
2004,61,124,10,914,2376,3485,SIHORE
2004,101,86,22,645,2287,3141,TIKAMGARH
2004,198,130,72,3871,5956,10227,UJJAIN
2004,37,60,4,317,912,1330,UMARIYA
2004,104,200,22,769,3012,4107,VIDISHA
2004,155,82,50,2395,2983,5665,AHMEDNAGAR
2004,100,76,46,2301,2748,5271,AKOLA
2004,39,34,42,1964,1541,3620,AMRAVATI COMMR.
2004,88,112,40,2117,2201,4558,AMRAVATI RURAL
2004,48,24,30,1456,1367,2925,AURANGABAD COMMR.
2004,62,20,22,864,2169,3137,AURANGABAD RURAL
2004,99,48,38,1853,2623,4661,BEED
2004,33,72,32,1203,1766,3106,BHANDARA
2004,83,78,40,1736,2488,4425,BULDHANA
2004,78,62,36,1710,2304,4190,CHANDRAPUR
2004,48,22,6,650,1606,2332,DHULE
2004,96,62,16,446,961,1581,GADCHIROLI
2004,38,60,42,841,1279,2260,GONDIA
2004,60,26,30,561,1278,1955,HINGOLI
2004,122,72,24,1576,2993,4787,JALGAON
2004,83,20,20,930,1901,2954,JALNA
2004,108,30,40,1492,2061,3731,KOLHAPUR
2004,92,44,38,999,2609,3782,LATUR
2004,380,374,356,26410,11650,39170,MUMBAI
2004,11,2,4,3582,245,3844,MUMBAI RLY.
2004,168,82,98,6233,4304,10885,NAGPUR COMMR.
2004,6,4,4,2064,290,2368,NAGPUR RLY.
2004,98,96,54,2532,3178,5958,NAGPUR RURAL
2004,173,62,46,1742,4258,6281,NANDED
2004,52,40,18,483,913,1506,NANDURBAR
2004,32,30,34,1991,1270,3357,NASIK COMMR.
2004,138,66,48,1217,3243,4712,NASIK RURAL
2004,93,34,38,2648,1853,4666,NAVI MUMBAI
2004,61,52,24,862,1789,2788,OSMANABAD
2004,73,26,24,821,1817,2761,PARBHANI
2004,176,126,140,8820,5064,14326,PUNE COMMR.
2004,4,0,0,270,147,421,PUNE RLY.
2004,163,62,52,2180,3147,5604,PUNE RURAL
2004,75,38,26,704,1540,2383,RAIGAD
2004,24,46,12,560,893,1535,RATNAGIRI
2004,95,60,28,1413,1485,3081,SANGLI
2004,87,44,40,1473,2266,3910,SATARA
2004,14,10,10,295,645,974,SINDHUDURG
2004,33,38,20,975,1022,2088,SOLAPUR COMMR.
2004,139,82,36,1091,2129,3477,SOLAPUR RURAL
2004,187,114,134,5527,2979,8941,THANE COMMR.
2004,188,120,84,1872,2544,4808,THANE RURAL
2004,67,62,50,1531,2593,4303,WARDHA
2004,49,38,34,980,1589,2690,WASHIM
2004,141,124,84,2366,3234,5949,YAVATMAL
2004,67,6,28,59,260,420,BISHNUPUR
2004,19,2,2,13,138,174,CHANDEL
2004,44,0,14,19,159,236,CHURACHANDPUR
2004,54,14,46,62,364,540,IMPHAL(EAST)
2004,86,18,76,326,765,1271,IMPHAL(WEST)
2004,18,0,14,18,178,228,SENAPATI
2004,2,0,10,14,125,151,TAMENGLONG
2004,84,22,64,31,294,495,THOUBAL
2004,12,0,2,19,126,159,UKHRUL
2004,16,0,6,69,128,219,GARO HILLS EAST
2004,7,2,4,23,113,149,GARO HILLS SOUTH
2004,30,24,20,95,181,350,GARO HILLS WEST
2004,35,22,12,162,245,476,JAINTIA HILLS
2004,45,34,58,605,334,1076,KHASI HILLS EAST
2004,15,18,4,74,146,257,KHASI HILLS WEST
2004,18,8,4,124,215,369,RI-BHOI
2004,17,12,12,775,278,1094,AIZAWL
2004,10,6,4,152,137,309,CHAMPHAI
2004,6,4,2,17,125,154,KOLASIB
2004,4,2,2,82,133,223,LAWNGTLAI
2004,7,4,4,233,190,438,LUNGLEI
2004,4,4,2,16,120,146,MAMIT
2004,5,2,2,121,153,283,SAIHA
2004,3,6,2,90,126,227,SERCHHIP
2004,27,4,18,290,185,524,DIMAPUR
2004,1,0,0,23,111,135,KIPHIRE
2004,17,20,18,105,187,347,KOHIMA
2004,9,2,2,27,135,175,MOKOKCHUNG
2004,12,0,4,75,137,228,MON
2004,4,4,0,7,106,121,PEREN
2004,8,2,0,13,124,147,PHEK
2004,13,2,0,25,131,171,TUENSANG
2004,8,0,4,84,132,228,WOKHA
2004,4,2,0,62,129,197,ZUNHEBOTO
2004,91,54,20,567,1389,2121,ANGUL
2004,50,88,70,571,1945,2724,BALASORE
2004,73,44,28,393,1055,1593,BARAGARH
2004,65,32,26,431,799,1353,BERHAMPUR
2004,62,62,34,264,1394,1816,BHADRAK
2004,90,66,12,406,1265,1839,BOLANGIR
2004,13,14,8,117,358,510,BOUDH
2004,161,90,102,1912,2469,4734,CUTTACK
2004,25,26,6,109,420,586,DEOGARH
2004,85,38,40,324,1113,1600,DHENKANAL
2004,23,10,14,79,380,506,GAJAPATI
2004,139,30,36,530,1320,2055,GANJAM
2004,59,38,58,366,1077,1598,JAGATSINGHPUR
2004,52,30,42,490,1429,2043,JAJPUR
2004,29,24,18,229,748,1048,JHARSUGUDA
2004,40,44,22,251,636,993,KALAHANDI
2004,37,52,34,208,629,960,KANDHAMAL
2004,55,38,16,234,840,1183,KENDRAPARA
2004,99,78,28,425,1520,2150,KEONJHAR
2004,123,88,114,3034,3032,6391,KHURDA
2004,85,80,40,378,1162,1745,KORAPUT
2004,77,38,4,112,405,636,MALKANGIR
2004,143,168,52,607,1563,2533,MAYURBHANJ
2004,49,34,40,293,644,1060,NAYAGARH
2004,33,32,26,177,549,817,NOWRANGPUR
2004,11,20,14,144,652,841,NUAPADA
2004,156,72,60,753,1884,2925,PURI
2004,45,38,8,183,791,1065,RAYAGADA
2004,44,20,18,563,868,1513,ROURKELA
2004,92,44,32,664,1301,2133,SAMBALPUR
2004,23,10,2,110,345,490,SONEPUR
2004,4,0,6,551,212,773,SRP(CUTTACK)
2004,10,4,0,194,208,416,SRP(ROURKELA)
2004,120,34,22,447,1253,1876,SUNDARGARH
2004,98,50,62,474,858,1542,AMRITSAR
2004,30,26,16,149,340,561,BARNALA
2004,60,16,16,137,430,659,BATALA
2004,69,44,52,387,825,1377,BHATINDA
2004,37,26,30,144,467,704,FARIDKOT
2004,32,8,20,129,442,631,FATEHGARH SAHIB
2004,94,60,38,439,1019,1650,FEROZEPUR
2004,11,0,0,61,394,466,G.R.P
2004,34,32,16,176,599,857,GURDASPUR
2004,62,46,42,227,874,1251,HOSHIARPUR
2004,57,40,56,295,652,1100,JAGRAON
2004,159,62,106,741,1711,2779,JALANDHAR
2004,45,24,24,166,560,819,KAPURTHALA
2004,37,16,28,179,244,504,KHANNA
2004,108,96,140,909,1806,3059,LUDHIANA
2004,57,28,32,152,493,762,MAJITHA
2004,64,16,10,107,458,655,MANSA
2004,57,22,28,179,558,844,MOGA
2004,38,14,20,161,412,645,MUKTSAR
2004,43,28,32,269,568,940,NAWAN SHAHR
2004,94,40,90,820,1911,2955,PATIALA
2004,39,16,24,353,867,1299,ROPAR
2004,94,42,32,339,823,1330,SANGRUR
2004,72,28,12,129,485,726,TARN TARAN
2004,123,96,202,2066,4912,7399,AJMER
2004,158,86,172,2513,5157,8086,ALWAR
2004,48,40,108,280,2633,3109,BANSWARA
2004,130,100,126,692,2451,3499,BARAN
2004,37,28,42,517,2029,2653,BARMER
2004,226,88,256,1784,5856,8210,BHARATPUR
2004,80,88,314,2042,4401,6925,BHILWARA
2004,150,82,62,1188,2784,4266,BIKANER
2004,119,94,198,877,3200,4488,BUNDI
2004,97,134,368,1688,5108,7395,CHITTORGARH
2004,66,30,62,529,2100,2787,CHURU
2004,45,28,100,1060,3257,4490,DAUSA
2004,82,62,88,670,2445,3347,DHOLPUR
2004,34,34,80,224,1688,2060,DUNGARPUR
2004,7,2,6,1114,483,1612,G.R.P.
2004,164,100,138,1207,3968,5577,GANGANAGAR
2004,145,76,70,800,2839,3930,HANUMANGARH
2004,199,162,454,9080,12662,22557,JAIPUR
2004,5,4,20,369,662,1060,JAISALMER
2004,50,10,54,331,2091,2536,JALORE
2004,144,80,176,1099,2752,4251,JHALAWAR
2004,44,52,80,779,3226,4181,JHUNJHUNU
2004,163,38,132,2756,4436,7525,JODHPUR
2004,52,90,150,726,2705,3723,KARAULI
2004,347,84,274,2780,4578,8063,KOTA
2004,89,50,80,1017,3269,4505,NAGAUR
2004,101,62,180,1148,4128,5619,PALI
2004,33,14,76,410,2128,2661,RAJSAMAND
2004,43,56,100,845,2525,3569,SAWAI MADHOPUR
2004,66,36,132,891,3227,4352,SIKAR
2004,72,28,66,513,1716,2395,SIROHI
2004,55,28,134,754,3131,4102,TONK
2004,135,114,268,1623,5380,7520,UDAIPUR
2004,7,2,2,162,287,460,EAST
2004,3,0,0,2,121,126,NORTH
2004,8,4,8,37,184,241,SOUTH
2004,6,0,0,14,212,232,WEST
2004,135,66,72,2352,10872,13497,CHENGAI
2004,277,60,74,7007,8009,15427,CHENNAI
2004,5,0,2,451,499,957,CHENNAI RLY.
2004,107,46,50,2637,8138,10978,COIMBATORE RURAL
2004,32,8,16,2296,2544,4896,COIMBATORE URBAN
2004,157,36,82,1060,6328,7663,CUDDALORE
2004,55,44,46,402,2454,3001,DHARMAPURI
2004,100,36,52,1144,4265,5597,DINDIGUL
2004,82,26,44,1503,5004,6659,ERODE
2004,100,34,24,873,6215,7246,KANCHIPURAM
2004,73,6,24,774,2591,3468,KANYAKUMARI
2004,37,8,12,466,2212,2735,KARUR
2004,74,18,54,677,4386,5209,KRISHNAGIRI
2004,102,58,58,1237,3340,4795,MADURAI RURAL
2004,48,16,54,1157,2370,3645,MADURAI URBAN
2004,76,18,42,606,3084,3826,NAGAPATTINAM
2004,51,14,36,441,3326,3868,NAMAKKAL
2004,40,28,6,392,1450,1916,NILGIRIS
2004,66,30,62,406,2181,2745,PERAMBALUR
2004,60,22,44,514,2935,3575,PUDUKOTTAI
2004,79,20,38,513,2474,3124,RAMNATHAPURAM
2004,251,112,204,624,4769,5960,SALEM RURAL
2004,36,22,12,571,2554,3195,SALEM URBAN
2004,59,26,42,714,2176,3017,SIVAGANGAI
2004,115,24,58,1130,3122,4449,THANJAVUR
2004,93,10,20,661,2866,3650,THENI
2004,155,60,42,1029,4036,5322,THIRUNELVELI RURAL
2004,59,6,12,357,1106,1540,THIRUNELVELI URBAN
2004,31,32,28,468,2873,3432,THIRUVALLUR
2004,50,54,50,900,3272,4326,THIRUVANNAMALAI
2004,49,14,20,482,2637,3202,THIRUVARUR
2004,152,70,62,1212,4041,5537,THOOTHUGUDI
2004,1,0,0,136,237,374,TRICHY RLY.
2004,87,32,60,384,3335,3898,TRICHY RURAL
2004,27,0,12,834,2165,3038,TRICHY URBAN
2004,96,34,60,1329,5843,7362,VELLORE
2004,146,110,112,921,5745,7034,VILLUPURAM
2004,88,36,54,1137,3822,5137,VIRUDHUNAGAR
2004,28,30,32,92,276,458,DHALAI
2004,44,92,60,165,465,826,NORTH
2004,43,102,56,194,724,1119,SOUTH
2004,110,96,50,310,862,1428,WEST
2004,278,64,312,2374,2941,5969,AGRA
2004,411,116,256,1851,2038,4672,ALIGARH
2004,292,46,158,1458,2492,4446,ALLAHABAD
2004,84,20,56,279,557,996,AMBEDKAR NAGAR
2004,87,8,90,148,641,974,AURAIYA
2004,173,32,94,476,1430,2205,AZAMGARH
2004,427,70,192,683,1481,2853,BADAUN
2004,186,22,58,298,596,1160,BAGHPAT
2004,89,32,60,364,908,1453,BAHRAICH
2004,117,12,38,341,792,1300,BALLIA
2004,35,10,14,78,268,405,BALRAMPUR
2004,98,42,38,272,750,1200,BANDA
2004,126,50,82,530,1135,1923,BARABANKI
2004,414,82,234,1504,2402,4636,BAREILLY
2004,64,14,42,324,730,1174,BASTI
2004,154,50,68,499,997,1768,BIJNOR
2004,339,80,180,982,1701,3282,BULANDSHAHAR
2004,37,10,14,143,527,731,CHANDOLI
2004,36,20,18,70,379,523,CHITRAKOOT DHAM
2004,104,24,58,256,928,1370,DEORIA
2004,364,52,126,565,1383,2490,ETAH
2004,146,18,126,296,1037,1623,ETAWAH
2004,81,24,38,339,765,1247,FAIZABAD
2004,174,20,80,230,485,989,FATEHGARH
2004,121,20,40,226,917,1324,FATEHPUR
2004,250,20,178,977,1387,2812,FIROZABAD
2004,27,4,10,3989,856,4886,G.R.P.
2004,123,40,64,1748,1147,3122,GAUTAMBUDH NAGAR
2004,350,50,236,3265,2146,6047,GHAZIABAD
2004,115,8,18,289,753,1183,GHAZIPUR
2004,109,28,46,325,646,1154,GONDA
2004,182,48,102,960,1565,2857,GORAKHPUR
2004,83,24,26,158,475,766,HAMIRPUR
2004,188,74,116,565,1418,2361,HARDOI
2004,156,32,80,599,1174,2041,HATHRAS
2004,135,54,48,331,909,1477,J.P.NAGAR
2004,143,14,98,320,731,1306,JALAUN
2004,126,38,44,442,1113,1763,JAUNPUR
2004,101,32,78,403,1269,1883,JHANSI
2004,105,10,34,190,763,1102,KANNAUJ
2004,83,26,98,335,1030,1572,KANPUR DEHAT
2004,275,40,218,2109,2670,5312,KANPUR NAGAR
2004,96,28,24,199,571,918,KAUSHAMBI
2004,231,86,152,825,1757,3051,KHIRI
2004,93,26,56,295,880,1350,KUSHI NAGAR
2004,32,8,8,126,399,573,LALITPUR
2004,308,92,328,5161,3501,9390,LUCKNOW
2004,47,16,22,117,490,692,MAHARAJGANJ
2004,53,12,18,86,381,550,MAHOBA
2004,244,16,98,451,1036,1845,MAINPURI
2004,191,48,68,887,1390,2584,MATHURA
2004,96,6,38,264,535,939,MAU
2004,404,66,274,2705,2036,5485,MEERUT
2004,73,24,26,232,656,1011,MIRZAPUR
2004,347,114,196,1305,2193,4155,MORADABAD
2004,416,88,180,1325,1492,3501,MUZAFFARNAGAR
2004,134,56,108,403,1131,1832,PILIBHIT
2004,134,36,62,462,1259,1953,PRATAPGARH
2004,136,84,104,537,1243,2104,RAIBAREILLY
2004,156,44,78,523,890,1691,RAMPUR
2004,210,44,104,1094,1428,2880,SAHARANPUR
2004,40,12,20,127,377,576,SANT KABIRNAGAR
2004,303,62,178,574,1313,2430,SHAHJAHANPUR
2004,29,8,18,94,338,487,SHRAWASTI
2004,35,20,34,260,647,996,SIDHARTHNAGAR
2004,283,144,208,1135,1763,3533,SITAPUR
2004,58,12,30,145,424,669,SONBHADRA
2004,56,6,10,199,443,714,ST.RAVIDASNAGAR
2004,137,36,72,585,864,1694,SULTANPUR
2004,230,90,124,390,1336,2170,UNNAO
2004,146,30,70,1332,1215,2793,VARANASI
2004,21,2,10,81,231,345,ALMORA
2004,5,10,8,27,155,205,BAGESHWAR
2004,19,8,14,47,257,345,CHAMOLI
2004,8,4,4,28,188,232,CHAMPAWAT
2004,77,42,74,1019,1122,2334,DEHRADUN
2004,122,66,108,963,1074,2333,HARIDWAR
2004,69,12,56,511,543,1191,NAINITAL
2004,32,12,20,165,345,574,PAURI GARHWAL
2004,14,18,6,75,313,426,PITHORAGARH
2004,5,8,6,37,181,237,RUDRA PRAYAG
2004,29,8,28,88,319,472,TEHRI GARHWAL
2004,98,30,82,846,1114,2170,UDHAMSINGH NAGAR
2004,10,10,10,76,240,346,UTTARKASHI
2004,220,352,360,4628,5552,11112,24 PARGANAS NORTH
2004,133,244,206,3260,4936,8779,24 PARGANAS SOUTH
2004,34,18,20,276,884,1232,ASANSOL
2004,37,98,48,804,1122,2109,BANKURA
2004,67,116,62,522,1166,1933,BIRBHUM
2004,120,184,112,920,3282,4618,BURDWAN
2004,24,184,82,316,950,1556,COOCHBEHAR
2004,20,66,54,215,705,1060,DAKSHIN DINAJPUR
2004,44,42,34,865,744,1729,DARJEELING
2004,94,112,76,1561,2552,4395,HOOGHLY
2004,35,42,38,473,1402,1990,HOWRAH
2004,34,30,34,908,1383,2389,HOWRAH CITY
2004,15,2,16,595,236,864,HOWRAH G.R.P.
2004,149,166,118,1381,1772,3586,JALPAIGURI
2004,10,0,4,243,125,382,KHARAGPUR G.R.P.
2004,115,54,238,7719,5238,13364,KOLKATA
2004,118,194,130,772,1736,2950,MALDA
2004,118,394,252,985,3119,4868,MURSHIDABAD
2004,99,216,160,1615,3011,5101,NADIA
2004,139,148,130,1006,2390,3813,PASCHIM MIDNAPUR
2004,60,98,108,502,1924,2692,PURAB MIDNAPUR
2004,40,86,22,334,858,1340,PURULIA
2004,16,10,12,581,187,806,SEALDAH G.R.P.
2004,3,0,4,166,150,323,SILIGURI G.R.P.
2004,71,94,80,520,1177,1942,UTTAR DINAJPUR
2004,14,20,6,270,610,920,ANDAMAN
2004,2,0,0,8,122,132,NICOBAR
2004,41,38,108,3112,1038,4337,CHANDIGARH
2004,15,14,24,131,362,546,D and N HAVELI
2004,3,2,4,90,198,297,DAMAN
2004,1,0,0,0,128,129,DIU
2004,33,54,114,2762,1645,4608,CENTRAL
2004,91,124,344,4760,2544,7863,EAST
2004,12,10,10,2156,199,2387,G.R.P.(RLY)
2004,4,2,10,183,208,407,I.G.I. AIRPORT
2004,21,16,40,2424,1052,3553,NEW DELHI
2004,48,46,170,2450,1871,4585,NORTH
2004,123,134,314,2308,2205,5084,NORTH EAST
2004,266,248,570,5777,5689,12550,NORTH WEST
2004,16,2,0,9,131,158,S.T.F.
2004,154,192,432,8360,4302,13440,SOUTH
2004,93,158,194,3980,3231,7656,SOUTH WEST
2004,139,116,220,5320,4091,9886,WEST
2004,0,0,0,12,167,179,LAKSHADWEEP
2004,43,8,20,1355,3840,5266,PONDICHERRY
2005,156,106,130,878,3971,5241,ADILABAD
2005,297,32,120,1094,3334,4877,ANANTAPUR
2005,145,70,144,2852,4670,7881,CHITTOOR
2005,96,42,72,766,3303,4279,CUDDAPAH
2005,238,88,302,5834,7038,13500,CYBERABAD
2005,240,54,138,3006,5824,9262,EAST GODAVARI
2005,12,0,2,263,176,453,GUNTAKAL RLY.
2005,253,110,174,2874,5211,8622,GUNTUR
2005,238,134,274,11341,8522,20509,HYDERABAD CITY
2005,260,168,262,1837,6387,8914,KARIMNAGAR
2005,179,42,132,1376,4437,6166,KHAMMAM
2005,143,54,90,1481,3968,5736,KRISHNA
2005,235,58,84,957,3998,5332,KURNOOL
2005,314,124,118,1491,4094,6141,MAHABOOBNAGAR
2005,178,72,76,1100,2972,4398,MEDAK
2005,184,98,102,1258,5100,6742,NALGONDA
2005,159,66,148,1755,3720,5848,NELLORE
2005,126,52,114,1336,3804,5432,NIZAMABAD
2005,188,54,104,1022,3179,4547,PRAKASHAM
2005,88,30,32,474,1685,2309,RANGA REDDY
2005,12,0,8,818,178,1016,SECUNDERABAD RLY.
2005,36,30,34,535,2269,2904,SRIKAKULAM
2005,81,64,174,3938,2947,7204,VIJAYAWADA
2005,7,0,2,522,146,677,VIJAYAWADA RLY.
2005,72,36,16,433,2325,2882,VISAKHA RURAL
2005,75,56,74,2393,2631,5229,VISAKHAPATNAM
2005,52,24,18,533,2165,2792,VIZIANAGARAM
2005,210,68,164,1654,4914,7010,WARANGAL
2005,200,138,116,2737,4804,7995,WEST GODAVARI
2005,15,4,16,71,176,282,CHANGLANG
2005,8,0,10,91,160,269,DIBANG VALLEY
2005,11,2,4,25,120,162,K/KUMEY
2005,6,4,8,54,152,224,KAMENG EAST
2005,6,0,2,65,161,234,KAMENG WEST
2005,19,6,14,70,173,282,LOHIT
2005,14,12,20,426,298,770,PAPUM PARE
2005,6,26,12,188,249,481,SIANG EAST
2005,5,4,2,40,140,191,SIANG UPPER
2005,5,6,10,141,220,382,SIANG WEST
2005,5,0,6,47,175,233,SUBANSIRI LOWER
2005,7,4,6,85,206,308,SUBANSIRI UPPER
2005,2,2,0,45,120,169,TAWANG
2005,5,0,4,58,163,230,TIRAP
2005,4,0,2,19,110,135,UPPER DIBANG VALLEY
2005,42,112,138,465,1536,2293,BARPETA
2005,32,18,48,89,274,461,BASKA
2005,22,76,62,221,668,1049,BONGAIGAON
2005,0,0,0,0,112,112,C.I.D.
2005,95,102,220,1046,2861,4324,CACHAR
2005,17,34,32,65,325,473,CHIRANG
2005,42,94,66,317,841,1360,DARRANG
2005,36,104,90,276,709,1215,DHEMAJI
2005,62,202,168,377,1759,2568,DHUBRI
2005,137,114,150,926,1289,2616,DIBRUGARH
2005,5,4,10,223,255,497,G.R.P.
2005,36,80,146,330,887,1479,GOALPARA
2005,79,108,174,631,835,1827,GOLAGHAT
2005,168,76,294,3350,3071,6959,GUWAHATI CITY
2005,22,36,70,205,742,1075,HAILAKANDI
2005,61,58,88,454,611,1272,JORHAT
2005,49,146,172,549,339,1255,KAMRUP
2005,91,16,78,233,495,913,KARBI ANGLONG
2005,55,56,62,392,801,1366,KARIMGANJ
2005,48,72,88,220,719,1147,KOKRAJHAR
2005,44,138,224,571,1102,2079,LAKHIMPUR
2005,28,104,94,301,699,1226,MORIGAON
2005,18,2,20,128,207,375,N.C.HILLS
2005,147,298,370,1113,2301,4229,NAGAON
2005,26,54,76,251,556,963,NALBARI
2005,14,16,10,33,199,272,R.P.O.
2005,82,76,146,653,1041,1998,SIBSAGAR
2005,94,154,216,1218,1817,3499,SONITPUR
2005,101,84,150,879,1088,2302,TINSUKIA
2005,44,42,40,284,491,901,UDALGURI
2005,80,58,86,383,1370,1977,ARARIA
2005,28,2,18,127,488,663,ARWAL
2005,224,34,66,636,1707,2667,AURANGABAD
2005,131,16,170,223,635,1175,BAGAHA
2005,92,86,88,332,1024,1622,BANKA
2005,181,40,130,629,1784,2764,BEGUSARAI
2005,183,102,228,760,2239,3512,BETTIAH
2005,122,28,82,383,875,1490,BHABHUA
2005,145,150,202,979,2146,3622,BHAGALPUR
2005,346,28,76,783,1969,3202,BHOJPUR
2005,176,12,60,747,974,1969,BUXAR
2005,122,130,108,684,2408,3452,DARBHANGA
2005,333,44,154,1222,2201,3954,GAYA
2005,283,48,130,540,1774,2775,GOPALGANJ
2005,8,0,6,237,151,402,JAMALPUR RLY.
2005,145,66,92,339,995,1637,JAMUI
2005,104,32,38,430,843,1447,JEHANABAD
2005,119,176,122,385,1322,2124,KATIHAR
2005,11,4,14,449,254,732,KATIHAR RLY.
2005,89,28,70,99,1306,1592,KHAGARIA
2005,40,122,168,308,695,1333,KISHANGANJ
2005,83,6,76,228,645,1038,LAKHISARAI
2005,76,30,26,180,977,1289,MADHEPURA
2005,177,84,132,569,2166,3128,MADHUBANI
2005,270,48,268,1109,3374,5069,MOTIHARI
2005,124,36,108,559,1265,2092,MUNGER
2005,153,160,450,1921,3590,6274,MUZAFFARPUR
2005,26,2,22,584,326,960,MUZAFFARPUR RLY.
2005,250,50,188,830,2070,3388,NALANDA
2005,72,12,72,202,831,1189,NAUGACHIA
2005,170,46,82,341,1303,1942,NAWADAH
2005,523,114,550,4032,8137,13356,PATNA
2005,21,0,4,1252,350,1627,PATNA RLY.
2005,148,78,120,647,1557,2550,PURNEA
2005,325,36,58,790,2600,3809,ROHTAS
2005,105,22,80,307,1106,1620,SAHARSA
2005,305,56,194,767,2459,3781,SAMASTIPUR
2005,470,64,170,883,2081,3668,SARAN
2005,33,2,46,129,641,851,SHEIKHPURA
2005,18,18,52,89,469,646,SHEOHAR
2005,88,64,148,516,2191,3007,SITAMARHI
2005,136,54,118,665,1523,2496,SIWAN
2005,66,80,48,301,976,1471,SUPAUL
2005,177,26,266,916,2537,3922,VAISHALI
2005,45,72,10,114,417,658,BALRAMPUR
2005,148,154,72,2144,3726,6244,BILASPUR
2005,198,10,2,87,213,510,BIZAPUR
2005,109,30,12,189,524,864,DANTEWARA
2005,18,52,18,395,1005,1488,DHAMTARI
2005,155,256,56,2482,4604,7553,DURG
2005,10,4,2,493,214,723,GRP RAIPUR
2005,107,148,18,547,1545,2365,JAGDALPUR
2005,70,86,20,836,2039,3051,JANJGIR
2005,83,136,38,265,626,1148,JASHPUR
2005,24,48,8,332,893,1305,KABIRDHAM
2005,68,64,22,228,819,1201,KANKER
2005,47,54,6,797,1563,2467,KORBA
2005,54,102,10,418,966,1550,KORIYA
2005,28,50,14,572,1132,1796,MAHASAMUND
2005,54,2,0,51,158,265,NARAYANPUR
2005,91,70,22,1074,1459,2716,RAIGARH
2005,151,250,92,2721,5187,8401,RAIPUR
2005,66,162,16,652,1863,2759,RAJNANDGAON
2005,74,148,38,645,1229,2134,SARGUJA
2005,73,82,16,409,843,1423,SURAJPUR
2005,32,22,14,768,802,1638,NORTH GOA
2005,28,18,20,517,495,1078,SOUTH GOA
2005,125,70,438,11728,10155,22516,AHMEDABAD COMMR.
2005,35,14,58,617,2519,3243,AHMEDABAD RURAL
2005,6,10,0,9,222,247,AHWA-DANG
2005,38,22,98,520,3190,3868,AMRELI
2005,27,14,48,784,2543,3416,ANAND
2005,45,16,46,807,2150,3064,BHARUCH
2005,97,28,170,2824,5461,8580,BHAVNAGAR
2005,61,18,58,381,1233,1751,DAHOD
2005,26,18,58,942,2082,3126,GANDHINAGAR
2005,38,24,64,624,3884,4634,HIMATNAGAR
2005,60,28,40,971,3233,4332,JAMNAGAR
2005,60,26,76,1212,4877,6251,JUNAGADH
2005,38,28,60,811,3452,4389,KHEDA NORTH
2005,58,18,90,1097,3579,4842,KUTCH
2005,51,12,110,1531,3708,5412,MEHSANA
2005,17,12,2,92,1059,1182,NARMADA
2005,17,12,12,253,1129,1423,NAVSARI
2005,64,22,46,835,3244,4211,PALANPUR
2005,56,24,64,665,2721,3530,PANCHMAHAL
2005,37,12,44,709,2222,3024,PATAN
2005,18,2,18,183,1017,1238,PORBANDAR
2005,36,14,74,2281,2573,4978,RAJKOT COMMR.
2005,67,36,112,956,3978,5149,RAJKOT RURAL
2005,109,46,228,4105,2503,6991,SURAT COMMR.
2005,55,18,28,483,1924,2508,SURAT RURAL
2005,51,26,76,767,2982,3902,SURENDRANAGAR
2005,50,10,78,3102,3285,6525,VADODARA COMMR.
2005,83,42,74,462,2612,3273,VADODARA RURAL
2005,47,22,50,825,1130,2074,VALSAD
2005,13,4,8,1947,595,2567,W.RLY
2005,40,38,48,747,1478,2351,AMBALA
2005,65,36,48,996,1469,2614,BHIWANI
2005,120,78,182,2607,3213,6200,FARIDABAD
2005,35,18,40,429,905,1427,FATEHABAD
2005,21,4,4,400,721,1150,GRP
2005,103,34,76,3395,1787,5395,GURGAON
2005,101,50,44,1340,1655,3190,HISSAR
2005,92,26,28,539,907,1592,JHAJJAR
2005,64,28,24,508,896,1520,JIND
2005,41,38,22,524,911,1536,KAITHAL
2005,77,100,62,1553,1844,3636,KARNAL
2005,40,48,30,1080,1452,2650,KURUKSHETRA
2005,19,30,26,331,892,1298,MAHENDRAGARH
2005,53,68,18,528,1214,1881,MEWAT
2005,11,16,30,596,814,1467,PANCHKULA
2005,61,112,70,1393,1212,2848,PANIPAT
2005,44,26,40,656,1305,2071,REWARI
2005,96,58,32,1099,1178,2463,ROHTAK
2005,54,30,32,714,1150,1980,SIRSA
2005,115,56,78,1155,1528,2932,SONIPAT
2005,45,28,50,851,1117,2091,YAMUNANAGAR
2005,20,16,18,154,1074,1282,BILASPUR
2005,17,24,16,183,477,717,CHAMBA
2005,0,0,0,12,107,119,G.R.P.
2005,6,8,8,136,934,1092,HAMIRPUR
2005,34,46,44,299,1781,2204,KANGRA
2005,4,8,6,58,270,346,KINNAUR
2005,23,38,48,245,710,1064,KULLU
2005,0,0,2,4,151,157,LAHAUL-SPITI
2005,19,16,20,191,1558,1804,MANDI
2005,21,64,28,391,1682,2186,SHIMLA
2005,17,22,18,99,688,844,SIRMAUR
2005,14,30,18,170,1147,1379,SOLAN
2005,14,10,10,174,697,905,UNA
2005,86,18,166,416,1063,1749,ANANTNAG
2005,36,14,22,138,338,548,AWANTIPORA
2005,171,32,218,499,983,1903,BARAMULLA
2005,22,10,18,69,533,652,BORDER
2005,56,12,126,367,628,1189,BUDGAM
2005,2,0,0,0,105,107,CRIME JAMMU
2005,0,0,0,0,105,105,CRIME SRINAGAR
2005,148,14,28,139,511,840,DODA
2005,16,10,78,162,386,652,GANDERBAL
2005,57,20,60,120,366,623,HANDWARA
2005,80,40,84,946,2371,3521,JAMMU
2005,0,2,4,13,176,195,KARGIL
2005,41,24,32,92,917,1106,KATHUA
2005,46,24,86,172,438,766,KULGAM
2005,82,22,80,153,486,823,KUPWARA
2005,2,10,6,29,239,286,LEH
2005,120,14,32,142,495,803,POONCH
2005,112,14,74,290,635,1125,PULWAMA
2005,1,0,2,18,114,135,RAILWAYS
2005,114,42,46,170,974,1346,RAJOURI
2005,92,12,24,113,557,798,RAMBAN
2005,65,2,24,67,290,448,REASI
2005,168,36,264,1041,1687,3196,SRINAGAR
2005,35,30,22,172,899,1158,UDHAMPUR
2005,62,72,86,1417,1478,3115,BOKARO
2005,169,106,4,330,668,1277,CHAIBASA
2005,27,22,18,227,631,925,CHATRA
2005,107,92,20,476,957,1652,DEOGHAR
2005,162,64,136,1749,2329,4440,DHANBAD
2005,5,4,4,84,127,224,DHANBAD RLY.
2005,70,76,46,438,1241,1871,DUMKA
2005,52,34,40,225,811,1162,GARHWA
2005,164,56,82,823,1634,2759,GIRIDIH
2005,127,92,58,303,917,1497,GODDA
2005,180,90,34,207,480,991,GUMLA
2005,138,114,110,1794,1850,4006,HAZARIBAGH
2005,190,74,86,1891,1700,3941,JAMSHEDPUR
2005,8,0,4,279,338,629,JAMSHEDPUR RLY.
2005,47,0,12,219,434,712,JAMTARA
2005,35,24,28,240,667,994,KODERMA
2005,35,24,12,174,389,634,LATEHAR
2005,94,50,36,245,390,815,LOHARDAGGA
2005,119,60,18,138,542,877,PAKUR
2005,126,54,88,460,1255,1983,PALAMU
2005,407,204,210,2806,2789,6416,RANCHI
2005,90,88,52,268,575,1073,SAHEBGANJ
2005,108,66,38,413,703,1328,SARAIKELA
2005,85,40,20,167,337,649,SIMDEGA
2005,71,8,30,388,1752,2249,BAGALKOT
2005,524,76,262,21716,14377,36955,BANGALORE COMMR.
2005,265,32,88,2214,6399,8998,BANGALORE RURAL
2005,195,26,82,1009,4659,5971,BELGAUM
2005,93,34,42,810,3741,4720,BELLARY
2005,82,10,24,526,3153,3795,BIDAR
2005,110,36,44,488,2489,3167,BIJAPUR
2005,53,14,16,355,1263,1701,CHAMARAJNAGAR
2005,60,32,18,558,2310,2978,CHICKMAGALUR
2005,35,30,12,594,3071,3742,CHITRADURGA
2005,64,28,28,800,3633,4553,DAKSHIN KANNADA
2005,56,28,28,738,2290,3140,DAVANAGERE
2005,28,0,14,704,1365,2111,DHARWAD COMMR.
2005,37,8,16,172,893,1126,DHARWAD RURAL
2005,43,2,14,205,907,1171,GADAG
2005,226,32,66,807,3968,5099,GULBARGA
2005,121,20,42,829,3454,4466,HASSAN
2005,33,8,12,306,1708,2067,HAVERI
2005,32,10,16,255,706,1019,K.G.F.
2005,63,20,20,277,1250,1630,KODAGU
2005,122,40,60,871,2445,3538,KOLAR
2005,51,16,16,263,1378,1724,KOPPAL
2005,99,34,24,718,2812,3687,MANDYA
2005,77,16,32,1408,1673,3206,MYSORE COMMR.
2005,77,28,16,670,2137,2928,MYSORE RURAL
2005,84,16,20,332,2266,2718,RAICHUR
2005,18,0,2,962,201,1183,RAILWAYS
2005,88,34,54,809,3464,4449,SHIMOGA
2005,118,28,48,1178,3439,4811,TUMKUR
2005,44,14,18,335,1984,2395,UDUPI
2005,46,6,14,234,2139,2439,UTTAR KANNADA
2005,44,44,36,708,6784,7616,ALAPUZHA
2005,13,2,0,16,210,241,CBCID
2005,27,14,12,1158,4979,6190,ERNAKULAM COMMR.
2005,44,30,28,998,7747,8847,ERNAKULAM RURAL
2005,57,56,14,560,3875,4562,IDUKKI
2005,41,50,14,598,4526,5229,KANNUR
2005,24,50,18,499,2533,3124,KASARGOD
2005,69,94,42,1375,8555,10135,KOLLAM
2005,37,50,34,1080,6603,7804,KOTTAYAM
2005,27,26,24,877,2752,3706,KOZHIKODE COMMR.
2005,18,72,22,708,3808,4628,KOZHIKODE RURAL
2005,61,100,26,1151,5689,7027,MALAPPURAM
2005,60,106,20,835,4625,5646,PALAKKAD
2005,36,28,18,504,3818,4404,PATHANAMTHITTA
2005,0,0,0,324,150,474,RAILWAYS
2005,76,76,46,1263,8209,9670,THRISSUR
2005,23,20,42,1421,4167,5673,TRIVANDRUM COMMR.
2005,59,72,44,1437,7555,9167,TRIVANDRUM RURAL
2005,13,66,12,395,1806,2292,WAYANADU
2005,35,62,14,372,1153,1636,ANUPPUR
2005,79,94,14,321,1560,2068,ASHOK NAGAR
2005,101,116,20,538,2338,3113,BALAGHAT
2005,61,82,10,554,1884,2591,BARWANI
2005,96,272,28,583,2325,3304,BETUL
2005,218,58,42,752,3149,4219,BHIND
2005,143,158,62,3790,8078,12231,BHOPAL
2005,5,2,2,2375,414,2798,BHOPAL RLY.
2005,25,28,2,334,1250,1639,BURHANPUR
2005,134,92,24,554,2978,3782,CHHATARPUR
2005,103,244,38,731,3163,4279,CHHINDWARA
2005,108,86,24,419,1815,2452,DAMOH
2005,98,60,40,401,1783,2382,DATIYA
2005,133,172,64,1759,4617,6745,DEWAS
2005,168,268,80,1537,3823,5876,DHAR
2005,27,64,2,75,646,814,DINDORI
2005,74,154,10,756,2674,3668,GUNA
2005,232,122,88,3839,5748,10029,GWALIOR
2005,33,64,14,257,917,1285,HARDA
2005,106,128,32,1027,2657,3950,HOSHANGABAD
2005,241,204,118,6431,11532,18526,INDORE
2005,2,6,0,272,270,550,INDORE RLY.
2005,208,184,72,2143,7467,10074,JABALPUR
2005,3,0,0,759,268,1030,JABALPUR RLY.
2005,197,74,96,432,1988,2787,JHABUA
2005,58,92,6,573,2024,2753,KATNI
2005,91,112,72,1309,3204,4788,KHANDWA
2005,82,122,18,1376,2897,4495,KHARGON
2005,59,122,16,204,1211,1612,MANDLA
2005,65,62,36,974,2273,3410,MANDSAUR
2005,167,64,60,1223,4006,5520,MORENA
2005,84,130,4,351,2166,2735,NARSINGHPUR
2005,31,54,18,794,1291,2188,NEEMUCH
2005,60,66,24,309,1166,1625,PANNA
2005,101,194,28,569,2728,3620,RAISEN
2005,73,150,38,991,3661,4913,RAJGARH
2005,84,148,26,1065,2914,4237,RATLAM
2005,99,128,52,1306,2805,4390,REWA
2005,181,220,62,1484,5725,7672,SAGAR
2005,131,150,36,1272,4026,5615,SATNA
2005,37,114,20,339,2073,2583,SEONI
2005,61,86,12,693,1876,2728,SHAHDOL
2005,76,146,30,1369,2463,4084,SHAJAPUR
2005,30,42,8,233,1015,1328,SHEOPUR
2005,159,116,44,801,2951,4071,SHIVPURI
2005,59,94,44,846,2875,3918,SIDHI
2005,96,146,22,968,2220,3452,SIHORE
2005,90,80,30,588,2196,2984,TIKAMGARH
2005,189,148,56,2663,5312,8368,UJJAIN
2005,32,68,6,273,954,1333,UMARIYA
2005,92,194,30,812,3083,4211,VIDISHA
2005,148,112,66,2571,3292,6189,AHMEDNAGAR
2005,86,42,48,2801,2785,5762,AKOLA
2005,55,46,22,1751,1511,3385,AMRAVATI COMMR.
2005,101,120,36,2131,2194,4582,AMRAVATI RURAL
2005,49,52,24,1550,1446,3121,AURANGABAD COMMR.
2005,63,18,12,847,2132,3072,AURANGABAD RURAL
2005,114,50,52,1962,2910,5088,BEED
2005,38,30,34,1138,1648,2888,BHANDARA
2005,113,84,46,1950,2758,4951,BULDHANA
2005,79,82,34,1770,2180,4145,CHANDRAPUR
2005,77,30,18,765,1723,2613,DHULE
2005,105,44,10,418,876,1453,GADCHIROLI
2005,50,44,36,982,1379,2491,GONDIA
2005,45,30,30,657,1455,2217,HINGOLI
2005,129,104,52,1730,2973,4988,JALGAON
2005,77,40,26,1014,2122,3279,JALNA
2005,127,52,50,1673,2035,3937,KOLHAPUR
2005,89,48,44,1075,2539,3795,LATUR
2005,348,402,396,27447,12652,41245,MUMBAI
2005,6,4,14,3183,241,3448,MUMBAI RLY.
2005,174,104,114,6934,4815,12141,NAGPUR COMMR.
2005,11,2,6,1834,250,2103,NAGPUR RLY.
2005,95,102,38,2696,3040,5971,NAGPUR RURAL
2005,182,82,84,1698,3960,6006,NANDED
2005,49,38,6,403,888,1384,NANDURBAR
2005,45,42,32,2088,1326,3533,NASIK COMMR.
2005,136,100,50,1480,3201,4967,NASIK RURAL
2005,72,38,30,2750,1939,4829,NAVI MUMBAI
2005,60,44,14,1113,2256,3487,OSMANABAD
2005,72,28,26,897,1711,2734,PARBHANI
2005,191,158,204,10080,4996,15629,PUNE COMMR.
2005,2,0,0,326,138,466,PUNE RLY.
2005,166,92,66,2484,3432,6240,PUNE RURAL
2005,63,50,16,996,1602,2727,RAIGAD
2005,24,54,14,735,930,1757,RATNAGIRI
2005,89,68,64,1739,1749,3709,SANGLI
2005,91,62,52,1907,2384,4496,SATARA
2005,23,8,8,350,643,1032,SINDHUDURG
2005,39,40,20,953,940,1992,SOLAPUR COMMR.
2005,135,80,52,1206,2406,3879,SOLAPUR RURAL
2005,158,120,170,5422,3324,9194,THANE COMMR.
2005,191,132,94,1887,2852,5156,THANE RURAL
2005,75,70,62,1365,2967,4539,WARDHA
2005,48,24,30,1003,1467,2572,WASHIM
2005,145,118,86,2915,3404,6668,YAVATMAL
2005,68,6,14,43,331,462,BISHNUPUR
2005,30,0,2,14,144,190,CHANDEL
2005,74,0,8,26,177,285,CHURACHANDPUR
2005,88,8,56,69,414,635,IMPHAL(EAST)
2005,117,20,82,318,743,1280,IMPHAL(WEST)
2005,22,0,6,16,186,230,SENAPATI
2005,9,2,2,8,135,156,TAMENGLONG
2005,84,14,40,59,418,615,THOUBAL
2005,16,0,2,7,142,167,UKHRUL
2005,16,8,14,96,163,297,GARO HILLS EAST
2005,7,0,4,40,119,170,GARO HILLS SOUTH
2005,15,6,22,131,244,418,GARO HILLS WEST
2005,46,20,14,158,214,452,JAINTIA HILLS
2005,52,50,38,606,344,1090,KHASI HILLS EAST
2005,15,24,0,108,170,317,KHASI HILLS WEST
2005,18,18,4,138,170,348,RI-BHOI
2005,8,20,10,554,257,849,AIZAWL
2005,7,10,2,190,182,391,CHAMPHAI
2005,3,4,0,170,149,326,KOLASIB
2005,6,4,4,201,195,410,LAWNGTLAI
2005,8,12,4,483,252,759,LUNGLEI
2005,6,12,4,52,148,222,MAMIT
2005,5,4,2,275,179,465,SAIHA
2005,5,8,0,80,177,270,SERCHHIP
2005,27,14,10,329,185,565,DIMAPUR
2005,0,0,0,6,118,124,KIPHIRE
2005,26,10,24,156,194,410,KOHIMA
2005,5,0,0,29,122,156,MOKOKCHUNG
2005,18,2,2,58,130,210,MON
2005,8,2,0,20,109,139,PEREN
2005,3,2,4,29,125,163,PHEK
2005,9,2,4,18,149,182,TUENSANG
2005,14,0,8,83,127,232,WOKHA
2005,3,2,0,45,122,172,ZUNHEBOTO
2005,87,56,30,752,1382,2307,ANGUL
2005,45,86,82,691,1926,2830,BALASORE
2005,87,42,24,542,1145,1840,BARAGARH
2005,75,12,14,601,963,1665,BERHAMPUR
2005,49,74,36,282,1409,1850,BHADRAK
2005,119,74,80,452,1087,1812,BOLANGIR
2005,20,14,4,84,393,515,BOUDH
2005,153,58,142,2025,2655,5033,CUTTACK
2005,30,32,16,125,474,677,DEOGARH
2005,92,16,24,362,1122,1616,DHENKANAL
2005,29,18,12,121,349,529,GAJAPATI
2005,122,52,50,471,1347,2042,GANJAM
2005,61,28,22,335,970,1416,JAGATSINGHPUR
2005,50,40,78,417,1437,2022,JAJPUR
2005,26,38,12,403,930,1409,JHARSUGUDA
2005,53,60,22,253,809,1197,KALAHANDI
2005,39,40,40,194,719,1032,KANDHAMAL
2005,71,46,40,309,910,1376,KENDRAPARA
2005,136,72,42,624,1647,2521,KEONJHAR
2005,114,114,130,3081,3102,6541,KHURDA
2005,65,90,54,442,1082,1733,KORAPUT
2005,72,14,14,112,405,617,MALKANGIR
2005,108,204,80,579,1575,2546,MAYURBHANJ
2005,35,34,50,311,768,1198,NAYAGARH
2005,42,36,16,178,619,891,NOWRANGPUR
2005,13,12,14,203,654,896,NUAPADA
2005,188,62,48,816,1761,2875,PURI
2005,47,34,6,223,801,1111,RAYAGADA
2005,42,34,24,621,923,1644,ROURKELA
2005,128,30,50,794,1379,2381,SAMBALPUR
2005,24,8,2,83,318,435,SONEPUR
2005,5,2,2,583,217,809,SRP(CUTTACK)
2005,4,2,6,212,189,413,SRP(ROURKELA)
2005,127,64,16,466,1325,1998,SUNDARGARH
2005,75,10,40,305,720,1150,AMRITSAR
2005,23,22,4,91,372,512,BARNALA
2005,52,48,36,214,818,1168,BATALA
2005,97,60,74,581,819,1631,BHATINDA
2005,53,12,20,178,411,674,FARIDKOT
2005,22,12,12,141,504,691,FATEHGARH SAHIB
2005,81,48,28,423,922,1502,FEROZPUR
2005,8,2,2,59,338,409,G.R.P
2005,49,32,34,210,679,1004,GURDASPUR
2005,64,46,38,251,823,1222,HOSHIARPUR
2005,39,24,32,251,661,1007,JAGRAON
2005,146,74,160,921,1673,2974,JALANDHAR
2005,49,36,48,340,689,1162,KAPURTHALA
2005,43,22,24,285,753,1127,KHANNA
2005,116,84,104,959,1613,2876,LUDHIANA
2005,56,18,36,188,520,818,MAJITHA
2005,46,30,22,133,451,682,MANSA
2005,56,18,36,222,595,927,MOGA
2005,56,36,46,240,492,870,MUKTSAR
2005,36,28,24,345,575,1008,NAWAN SHAHR
2005,91,38,48,854,1934,2965,PATIALA
2005,37,36,24,368,873,1338,ROPAR
2005,67,22,42,292,767,1190,SANGRUR
2005,74,38,22,145,482,761,TARN TARAN
2005,97,52,178,2092,4113,6532,AJMER
2005,171,104,172,2390,4809,7646,ALWAR
2005,41,58,66,296,2098,2559,BANSWARA
2005,114,90,94,618,2267,3183,BARAN
2005,55,38,52,463,2008,2616,BARMER
2005,202,92,176,1636,5195,7301,BHARATPUR
2005,83,78,272,1971,3367,5771,BHILWARA
2005,125,60,40,887,2558,3670,BIKANER
2005,95,82,140,585,2508,3410,BUNDI
2005,107,122,266,1407,4201,6103,CHITTORGARH
2005,52,36,56,375,1802,2321,CHURU
2005,48,24,60,1190,2662,3984,DAUSA
2005,118,50,106,619,2311,3204,DHOLPUR
2005,32,18,62,146,1323,1581,DUNGARPUR
2005,7,4,4,945,509,1469,G.R.P.
2005,173,90,106,1140,3450,4959,GANGANAGAR
2005,127,72,56,605,2366,3226,HANUMANGARH
2005,183,164,422,8962,12725,22456,JAIPUR
2005,7,4,18,295,598,922,JAISALMER
2005,37,10,44,356,1777,2224,JALORE
2005,127,80,136,931,2596,3870,JHALAWAR
2005,40,62,58,650,2751,3561,JHUNJHUNU
2005,149,58,150,2869,3952,7178,JODHPUR
2005,46,44,124,808,2522,3544,KARAULI
2005,347,80,218,2579,4306,7530,KOTA
2005,65,66,86,881,3085,4183,NAGAUR
2005,68,72,136,880,3706,4862,PALI
2005,37,16,94,436,1931,2514,RAJSAMAND
2005,51,46,72,867,2423,3459,SAWAI MADHOPUR
2005,97,42,136,945,3384,4604,SIKAR
2005,54,46,48,461,1675,2284,SIROHI
2005,50,36,128,833,3123,4170,TONK
2005,136,90,210,1615,4770,6821,UDAIPUR
2005,15,16,4,130,219,384,EAST
2005,2,2,0,19,121,144,NORTH
2005,4,12,2,83,180,281,SOUTH
2005,3,6,0,21,143,173,WEST
2005,298,86,110,6787,15487,22768,CHENNAI
2005,2,0,0,190,365,557,CHENNAI RLY.
2005,209,66,94,3082,7740,11191,COIMBATORE RURAL
2005,39,12,8,1978,2655,4692,COIMBATORE URBAN
2005,150,64,64,1012,5745,7035,CUDDALORE
2005,63,14,62,419,2393,2951,DHARMAPURI
2005,124,34,72,937,4131,5298,DINDIGUL
2005,83,44,44,1349,5440,6960,ERODE
2005,104,36,58,973,4452,5623,KANCHIPURAM
2005,71,26,32,635,2545,3309,KANYAKUMARI
2005,48,12,30,582,2545,3217,KARUR
2005,63,20,60,814,4442,5399,KRISHNAGIRI
2005,106,48,72,1001,4631,5858,MADURAI RURAL
2005,61,10,40,986,2591,3688,MADURAI URBAN
2005,74,24,40,510,3294,3942,NAGAPATTINAM
2005,55,0,70,447,3009,3581,NAMAKKAL
2005,32,26,18,316,1502,1894,NILGIRIS
2005,68,38,38,450,2326,2920,PERAMBALUR
2005,62,28,68,624,3304,4086,PUDUKOTTAI
2005,57,10,34,303,2648,3052,RAMNATHAPURAM
2005,225,104,214,711,5097,6351,SALEM RURAL
2005,25,8,24,567,3677,4301,SALEM URBAN
2005,55,4,18,560,2060,2697,SIVAGANGAI
2005,118,18,90,1389,3126,4741,THANJAVUR
2005,80,6,34,537,2798,3455,THENI
2005,183,54,52,843,4766,5898,THIRUNELVELI RURAL
2005,57,4,20,351,974,1406,THIRUNELVELI URBAN
2005,46,30,42,470,2732,3320,THIRUVALLUR
2005,51,52,70,743,2453,3369,THIRUVANNAMALAI
2005,36,8,22,536,2707,3309,THIRUVARUR
2005,134,34,50,998,3772,4988,THOOTHUGUDI
2005,1,0,0,157,217,375,TRICHY RLY.
2005,85,38,106,601,3417,4247,TRICHY RURAL
2005,28,2,14,718,2506,3268,TRICHY URBAN
2005,81,46,74,1318,5436,6955,VELLORE
2005,151,98,98,728,5316,6391,VILUPPURAM
2005,74,38,116,1328,4286,5842,VIRUDHUNAGAR
2005,17,30,42,77,305,471,DHALAI
2005,44,94,38,200,519,895,NORTH
2005,35,84,42,279,689,1129,SOUTH
2005,81,116,48,347,1004,1596,WEST
2005,241,58,240,2426,2805,5770,AGRA
2005,376,122,224,1990,2271,4983,ALIGARH
2005,262,34,134,1224,2240,3894,ALLAHABAD
2005,88,22,64,316,577,1067,AMBEDKAR NAGAR
2005,99,18,72,210,727,1126,AURAIYA
2005,175,20,68,530,1427,2220,AZAMGARH
2005,361,44,154,432,1251,2242,BADAUN
2005,152,26,66,316,655,1215,BAGHPAT
2005,93,50,82,331,782,1338,BAHRAICH
2005,88,4,16,258,638,1004,BALLIA
2005,29,12,10,109,274,434,BALRAMPUR
2005,99,32,32,237,720,1120,BANDA
2005,115,60,70,502,1163,1910,BARABANKI
2005,433,96,214,1213,2420,4376,BAREILLY
2005,45,26,26,253,639,989,BASTI
2005,113,44,70,490,967,1684,BIJNOR
2005,322,66,162,810,1757,3117,BULANDSHAHAR
2005,53,12,12,113,406,596,CHANDOLI
2005,33,20,18,56,384,511,CHITRAKOOT DHAM
2005,75,14,38,252,823,1202,DEORIA
2005,328,32,118,481,1191,2150,ETAH
2005,126,24,142,255,1243,1790,ETAWAH
2005,98,22,70,358,844,1392,FAIZABAD
2005,138,20,62,188,535,943,FATEHGARH
2005,133,14,56,205,875,1283,FATEHPUR
2005,239,34,142,834,1336,2585,FIROZABAD
2005,31,6,8,2251,800,3096,G.R.P.
2005,127,36,102,2060,714,3039,GAUTAMBUDH NAGAR
2005,318,48,206,2918,1968,5458,GHAZIABAD
2005,93,4,16,275,620,1008,GHAZIPUR
2005,90,24,36,362,654,1166,GONDA
2005,161,48,58,899,1367,2533,GORAKHPUR
2005,74,18,28,138,488,746,HAMIRPUR
2005,143,62,90,491,1336,2122,HARDOI
2005,153,24,58,649,1060,1944,HATHRAS
2005,106,44,34,328,821,1333,J.P.NAGAR
2005,92,6,28,213,1370,1709,JALAUN
2005,100,26,48,385,920,1479,JAUNPUR
2005,69,6,22,297,622,1016,JHANSI
2005,116,10,76,212,657,1071,KANNAUJ
2005,83,16,122,332,1105,1658,KANPUR DEHAT
2005,241,36,214,1801,2016,4308,KANPUR NAGAR
2005,95,18,22,142,555,832,KAUSHAMBI
2005,272,90,138,567,1480,2547,KHIRI
2005,76,12,44,260,859,1251,KUSHI NAGAR
2005,24,2,4,55,298,383,LALITPUR
2005,350,102,300,5269,3858,9879,LUCKNOW
2005,43,18,30,136,445,672,MAHARAJGANJ
2005,56,8,2,68,378,512,MAHOBA
2005,232,10,82,351,976,1651,MAINPURI
2005,218,36,108,1059,1500,2921,MATHURA
2005,75,10,16,223,575,899,MAU
2005,407,74,278,2399,2176,5334,MEERUT
2005,71,12,20,314,643,1060,MIRZAPUR
2005,337,104,196,1334,2061,4032,MORADABAD
2005,394,88,160,1453,1734,3829,MUZAFFARNAGAR
2005,118,48,74,226,905,1371,PILIBHIT
2005,134,30,74,433,966,1637,PRATAPGARH
2005,153,52,82,581,1195,2063,RAIBAREILLY
2005,126,34,66,398,748,1372,RAMPUR
2005,201,30,62,859,1467,2619,SAHARANPUR
2005,28,6,32,136,362,564,SANT KABIRNAGAR
2005,259,52,110,459,1181,2061,SHAHJAHANPUR
2005,35,12,26,116,278,467,SHRAWASTI
2005,32,8,38,209,531,818,SIDHARTHNAGAR
2005,769,102,178,1108,1434,3591,SITAPUR
2005,41,16,14,149,402,622,SONBHADRA
2005,38,2,4,201,377,622,ST.RAVIDASNAGAR
2005,145,32,66,519,812,1574,SULTANPUR
2005,170,70,108,467,1175,1990,UNNAO
2005,138,16,68,879,1023,2124,VARANASI
2005,29,12,12,129,224,406,ALMORA
2005,15,14,4,44,158,235,BAGESHWAR
2005,13,8,10,79,259,369,CHAMOLI
2005,7,2,6,41,174,230,CHAMPAWAT
2005,81,46,90,1042,976,2235,DEHRADUN
2005,121,64,108,1057,951,2301,HARIDWAR
2005,60,14,32,409,599,1114,NAINITAL
2005,23,14,8,177,317,539,PAURI GARHWAL
2005,12,14,8,87,249,370,PITHORAGARH
2005,15,4,8,51,171,249,RUDRA PRAYAG
2005,21,18,16,66,254,375,TEHRI GARHWAL
2005,74,42,94,722,986,1918,UDHAMSINGH NAGAR
2005,10,14,10,84,222,340,UTTARKASHI
2005,238,434,422,3459,5110,9663,24 PARGANAS NORTH
2005,139,272,236,2659,4592,7898,24 PARGANAS SOUTH
2005,29,18,28,364,1024,1463,ASANSOL
2005,59,86,54,631,1072,1902,BANKURA
2005,66,156,82,557,1194,2055,BIRBHUM
2005,120,226,106,1211,3485,5148,BURDWAN
2005,40,164,60,248,985,1497,COOCHBEHAR
2005,32,56,66,227,750,1131,DAKSHIN DINAJPUR
2005,54,78,34,721,969,1856,DARJEELING
2005,64,84,64,1162,2425,3799,HOOGHLY
2005,52,82,68,315,1361,1878,HOWRAH
2005,35,40,42,1096,1694,2907,HOWRAH CITY
2005,13,0,16,661,243,933,HOWRAH G.R.P.
2005,109,216,122,1510,1708,3665,JALPAIGURI
2005,2,2,2,224,128,358,KHARAGPUR G.R.P.
2005,116,26,164,5539,5070,10915,KOLKATA
2005,116,192,88,721,1537,2654,MALDA
2005,138,472,242,1133,2716,4701,MURSHIDABAD
2005,100,296,204,1625,3144,5369,NADIA
2005,117,184,90,811,1984,3186,PASCHIM MIDNAPUR
2005,61,108,108,505,1676,2458,PURAB MIDNAPUR
2005,61,68,16,330,774,1249,PURULIA
2005,24,6,18,389,152,589,SEALDAH G.R.P.
2005,2,0,4,198,137,341,SILIGURI G.R.P.
2005,100,106,78,549,1246,2079,UTTAR DINAJPUR
2005,17,8,4,247,554,830,ANDAMAN
2005,0,0,0,9,114,123,NICOBAR
2005,33,66,108,2983,1270,4460,CHANDIGARH
2005,12,10,26,178,377,603,D and N HAVELI
2005,6,4,8,116,203,337,DAMAN
2005,1,0,0,25,134,160,DIU
2005,51,40,104,2471,1984,4650,CENTRAL
2005,69,118,306,4334,2693,7520,EAST
2005,20,4,8,2115,193,2340,G.R.P.(RLY)
2005,1,2,8,162,219,392,IGI AIRPORT
2005,21,12,38,1663,1196,2930,NEW DELHI
2005,47,44,156,1938,1989,4174,NORTH
2005,114,212,424,2806,2742,6298,NORTH-EAST
2005,249,380,1144,5905,6410,14088,NORTH-WEST
2005,130,174,462,8626,5064,14456,SOUTH
2005,98,142,228,3546,3286,7300,SOUTH-WEST
2005,10,0,0,3,134,147,SPL CELL
2005,112,188,302,5128,3892,9622,WEST
2005,1,0,0,16,136,153,LAKSHADWEEP
2005,43,12,12,1005,3968,5040,PONDICHERRY
2006,187,128,192,1035,4822,6364,ADILABAD
2006,300,32,134,1296,3750,5512,ANANTAPUR
2006,185,62,130,2344,4622,7343,CHITTOOR
2006,98,50,136,930,4322,5536,CUDDAPAH
2006,285,120,332,6099,8485,15321,CYBERABAD
2006,201,82,162,3324,6290,10059,EAST GODAVARI
2006,7,0,2,289,165,463,GUNTAKAL RLY.
2006,274,94,198,3023,6225,9814,GUNTUR
2006,241,186,286,10113,9161,19987,HYDERABAD CITY
2006,250,146,302,1648,5930,8276,KARIMNAGAR
2006,193,88,182,1410,4553,6426,KHAMMAM
2006,133,72,108,1265,4112,5690,KRISHNA
2006,233,70,170,951,4473,5897,KURNOOL
2006,266,134,146,1703,4634,6883,MAHABOOBNAGAR
2006,203,114,126,1438,4146,6027,MEDAK
2006,179,122,172,1296,6419,8188,NALGONDA
2006,152,70,138,1549,4394,6303,NELLORE
2006,193,72,142,1576,4283,6266,NIZAMABAD
2006,203,46,166,1432,4199,6046,PRAKASHAM
2006,83,18,58,344,1683,2186,RANGA REDDY
2006,11,4,6,454,160,635,SECUNDERABAD RLY.
2006,46,54,42,549,2532,3223,SRIKAKULAM
2006,93,42,172,3419,3233,6959,VIJAYAWADA CITY
2006,3,0,0,521,170,694,VIJAYAWADA RLY.
2006,94,12,22,469,2798,3395,VISAKHA RURAL
2006,67,42,98,2690,3486,6383,VISAKHAPATNAM
2006,52,32,40,445,2561,3130,VIZIANAGARAM
2006,205,100,206,1775,6031,8317,WARANGAL
2006,189,106,192,2797,4880,8164,WEST GODAVARI
2006,6,8,8,86,174,282,CHANGLANG
2006,7,4,4,60,182,257,DIBANG VALLEY
2006,6,4,6,11,119,146,K/KUMEY
2006,3,2,6,49,181,241,KAMENG EAST
2006,5,4,4,52,163,228,KAMENG WEST
2006,9,6,20,107,182,324,LOHIT
2006,21,10,40,374,326,771,PAPUM PARE
2006,10,14,12,155,211,402,SIANG EAST
2006,1,4,4,45,145,199,SIANG UPPER
2006,7,0,14,131,239,391,SIANG WEST
2006,5,6,10,56,162,239,SUBANSIRI LOWER
2006,4,4,8,55,194,265,SUBANSIRI UPPER
2006,0,0,0,34,130,164,TAWANG
2006,9,8,14,38,154,223,TIRAP
2006,0,0,0,8,112,120,UPPER DIBANG VALLEY
2006,60,116,150,524,1363,2213,BARPETA
2006,30,28,48,70,318,494,BASKA
2006,16,26,38,172,570,822,BONGAIGAON
2006,0,0,2,2,114,118,C.I.D.
2006,76,120,258,1195,2713,4362,CACHAR
2006,43,60,52,199,427,781,CHIRANG
2006,39,140,106,445,914,1644,DARRANG
2006,56,116,90,340,701,1303,DHEMAJI
2006,77,230,236,487,1831,2861,DHUBRI
2006,129,106,130,989,1242,2596,DIBRUGARH
2006,6,2,2,382,248,640,G.R.P.
2006,32,110,80,265,788,1275,GOALPARA
2006,96,126,182,654,876,1934,GOLAGHAT
2006,103,66,302,4245,1927,6643,GUWAHATI CITY
2006,19,46,112,258,765,1200,HAILAKANDI
2006,43,60,108,613,1006,1830,JORHAT
2006,46,74,160,431,742,1453,KAMRUP
2006,56,28,80,346,468,978,KARBI ANGLONG
2006,60,88,92,495,784,1519,KARIMGANJ
2006,52,58,94,272,723,1199,KOKRAJHAR
2006,47,158,192,466,1131,1994,LAKHIMPUR
2006,30,116,112,281,885,1424,MORIGAON
2006,29,8,28,72,228,365,N.C.HILLS
2006,116,266,358,1124,2347,4211,NAGAON
2006,45,34,66,229,657,1031,NALBARI
2006,5,6,10,23,163,207,R.P.O.
2006,107,108,158,876,1222,2471,SIBSAGAR
2006,104,112,216,961,1352,2745,SONITPUR
2006,61,46,114,2798,906,3925,TINSUKIA
2006,38,34,74,212,398,756,UDALGURI
2006,100,84,208,462,1993,2847,ARARIA
2006,75,0,18,135,474,702,ARWAL
2006,257,36,84,673,1573,2623,AURANGABAD
2006,57,54,88,343,894,1436,BAGAHA
2006,89,140,82,325,1162,1798,BANKA
2006,336,46,138,784,1912,3216,BEGUSARAI
2006,179,98,220,771,2178,3446,BETTIAH
2006,69,44,70,510,1043,1736,BHABHUA
2006,213,86,166,1073,2511,4049,BHAGALPUR
2006,362,34,114,802,2254,3566,BHOJPUR
2006,113,20,96,665,1100,1994,BUXAR
2006,144,148,136,666,2412,3506,DARBHANGA
2006,336,50,136,1223,2193,3938,GAYA
2006,118,46,110,556,1825,2655,GOPALGANJ
2006,4,0,0,213,154,371,JAMALPUR RLY.
2006,151,58,56,356,1158,1779,JAMUI
2006,53,20,40,245,930,1288,JEHANABAD
2006,105,164,114,369,1298,2050,KATIHAR
2006,10,6,12,581,266,875,KATIHAR RLY.
2006,201,44,94,316,1339,1994,KHAGARIA
2006,23,162,168,214,822,1389,KISHANGANJ
2006,159,24,60,172,725,1140,LAKHISARAI
2006,84,20,32,297,956,1389,MADHEPURA
2006,151,116,152,414,655,1488,MADHUBANI
2006,261,44,200,1138,3095,4738,MOTIHARI
2006,108,26,106,505,1385,2130,MUNGER
2006,158,96,296,2299,3640,6489,MUZAFFARPUR
2006,23,6,28,758,342,1157,MUZAFFARPUR RLY.
2006,234,62,152,864,2058,3370,NALANDA
2006,49,16,24,122,859,1070,NAUGACHIA
2006,211,40,72,328,1122,1773,NAWADAH
2006,426,108,618,4416,8828,14396,PATNA
2006,31,2,14,1292,333,1672,PATNA RLY.
2006,80,82,88,610,1927,2787,PURNEA
2006,190,34,90,755,2366,3435,ROHTAS
2006,141,66,82,299,1328,1916,SAHARSA
2006,297,106,218,916,2280,3817,SAMASTIPUR
2006,424,96,208,894,2258,3880,SARAN
2006,32,10,18,171,513,744,SHEIKHPURA
2006,44,4,38,86,451,623,SHEOHAR
2006,75,54,122,636,1992,2879,SITAMARHI
2006,165,36,206,675,1689,2771,SIWAN
2006,76,48,62,238,1083,1507,SUPAUL
2006,138,28,202,1178,2746,4292,VAISHALI
2006,61,90,2,110,464,727,BALRAMPUR
2006,157,136,54,1954,3644,5945,BILASPUR
2006,320,12,14,64,224,634,BIZAPUR
2006,173,28,32,193,525,951,DANTEWARA
2006,32,54,8,379,1173,1646,DHAMTARI
2006,125,216,66,2313,4959,7679,DURG
2006,5,2,0,476,234,717,GRP RAIPUR
2006,100,142,28,532,1672,2474,JAGDALPUR
2006,90,80,24,766,2157,3117,JANJGIR
2006,57,124,16,231,724,1152,JASHPUR
2006,24,72,2,254,977,1329,KABIRDHAM
2006,76,46,18,256,815,1211,KANKER
2006,60,80,10,776,1715,2641,KORBA
2006,62,102,14,355,1022,1555,KORIYA
2006,37,64,6,543,1123,1773,MAHASAMUND
2006,66,4,10,15,174,269,NARAYANPUR
2006,75,76,14,969,1618,2752,RAIGARH
2006,172,260,108,3026,5438,9004,RAIPUR
2006,81,138,20,651,1973,2863,RAJNANDGAON
2006,82,150,22,456,1087,1797,SARGUJA
2006,68,114,10,335,836,1363,SURAJPUR
2006,32,16,18,740,743,1549,NORTH GOA
2006,24,26,14,524,697,1285,SOUTH GOA
2006,159,92,364,11776,11925,24316,AHMEDABAD COMMR.
2006,51,20,56,666,2556,3349,AHMEDABAD RURAL
2006,8,6,0,37,345,396,AHWA-DANG
2006,31,30,62,463,2108,2694,AMRELI
2006,32,28,66,866,2474,3466,ANAND
2006,46,14,14,763,2140,2977,BHARUCH
2006,99,52,256,3368,5896,9671,BHAVNAGAR
2006,48,0,42,253,1564,1907,DAHOD
2006,36,28,48,931,2285,3328,GANDHINAGAR
2006,39,22,64,557,6119,6801,HIMATNAGAR
2006,40,26,42,929,3306,4343,JAMNAGAR
2006,73,12,104,1174,3821,5184,JUNAGADH
2006,46,34,72,835,3952,4939,KHEDA NORTH
2006,62,38,104,1452,4917,6573,KUTCH
2006,46,12,82,1574,3569,5283,MEHSANA
2006,19,4,12,88,649,772,NARMADA
2006,22,4,16,295,1012,1349,NAVSARI
2006,60,44,74,1016,4320,5514,PALANPUR
2006,75,12,88,549,2981,3705,PANCHMAHAL
2006,23,20,26,906,2160,3135,PATAN
2006,14,4,14,196,898,1126,PORBANDAR
2006,44,8,52,1723,2458,4285,RAJKOT COMMR.
2006,62,42,74,1074,3304,4556,RAJKOT RURAL
2006,133,62,260,5001,5314,10770,SURAT COMMR.
2006,78,22,22,441,2048,2611,SURAT RURAL
2006,45,34,46,662,2275,3062,SURENDRANAGAR
2006,66,12,108,3163,3558,6907,VADODARA COMMR.
2006,101,20,40,443,2253,2857,VADODARA RURAL
2006,60,2,36,732,1567,2397,VALSAD
2006,18,4,12,1819,388,2241,W.RLY
2006,51,38,44,1215,1677,3025,AMBALA
2006,74,70,68,1026,1706,2944,BHIWANI
2006,103,80,172,2924,2681,5960,FARIDABAD
2006,38,36,40,472,1027,1613,FATEHABAD
2006,24,2,2,543,640,1211,GRP
2006,156,60,140,4872,2331,7559,GURGAON
2006,116,46,62,1288,2129,3641,HISSAR
2006,85,30,20,488,878,1501,JHAJJAR
2006,69,64,30,636,1140,1939,JIND
2006,35,50,28,714,1068,1895,KAITHAL
2006,61,102,80,1682,1920,3845,KARNAL
2006,43,68,48,1300,1576,3035,KURUKSHETRA
2006,40,34,52,471,1516,2113,MAHENDRAGARH
2006,42,70,28,454,1240,1834,MEWAT
2006,57,52,46,575,1085,1815,PALWAL
2006,20,20,30,572,1017,1659,PANCHKULA
2006,71,130,92,1596,1365,3254,PANIPAT
2006,58,42,30,756,1452,2338,REWARI
2006,98,68,46,1214,1280,2706,ROHTAK
2006,65,36,22,719,1320,2162,SIRSA
2006,108,62,134,1324,1892,3520,SONIPAT
2006,44,56,56,934,1180,2270,YAMUNANAGAR
2006,15,22,8,166,1113,1324,BILASPUR
2006,18,8,24,186,493,729,CHAMBA
2006,0,0,0,2,108,110,G.R.P.
2006,14,2,8,151,1028,1203,HAMIRPUR
2006,38,24,50,320,1871,2303,KANGRA
2006,2,4,10,51,284,351,KINNAUR
2006,9,20,18,188,749,984,KULLU
2006,1,0,2,7,153,163,LAHAUL-SPITI
2006,18,36,24,220,1694,1992,MANDI
2006,29,68,56,499,1608,2260,SHIMLA
2006,19,6,12,159,702,898,SIRMAUR
2006,13,18,36,257,1275,1599,SOLAN
2006,13,18,12,208,772,1023,UNA
2006,52,44,176,412,1079,1763,ANANTNAG
2006,24,18,24,68,303,437,AWANTIPORA
2006,178,30,222,401,1013,1844,BARAMULLA
2006,24,12,24,80,558,698,BORDER DISTRICT
2006,43,10,108,458,744,1363,BUDGAM
2006,3,0,0,0,105,108,CRIME JAMMU
2006,0,0,0,0,104,104,CRIME SRINAGAR
2006,159,20,72,146,651,1048,DODA
2006,27,8,70,144,403,652,GANDERBAL
2006,46,16,54,98,359,573,HANDWARA
2006,76,42,116,935,2485,3654,JAMMU
2006,1,0,8,23,186,218,KARGIL
2006,28,24,54,170,980,1256,KATHUA
2006,48,28,94,193,463,826,KULGAM
2006,72,22,62,104,452,712,KUPWARA
2006,7,6,10,26,258,307,LEH
2006,95,42,42,120,594,893,POONCH
2006,85,18,114,346,616,1179,PULWAMA
2006,0,0,0,20,114,134,RAILWAYS
2006,61,52,74,186,1170,1543,RAJOURI
2006,51,28,10,113,658,860,RAMBAN
2006,58,14,20,41,302,435,REASI
2006,171,44,204,1099,1464,2982,SRINAGAR
2006,32,22,20,164,846,1084,UDHAMPUR
2006,45,48,98,1179,1573,2943,BOKARO
2006,164,106,24,376,644,1314,CHAIBASA
2006,30,26,22,188,685,951,CHATRA
2006,39,66,16,535,1433,2089,DEOGHAR
2006,150,74,130,1816,2378,4548,DHANBAD
2006,11,0,0,310,203,524,DHANBAD RLY.
2006,68,110,56,442,1129,1805,DUMKA
2006,54,52,28,241,987,1362,GARHWA
2006,201,112,70,849,1856,3088,GIRIDIH
2006,119,66,50,351,896,1482,GODDA
2006,184,110,52,238,650,1234,GUMLA
2006,200,90,154,1490,1660,3594,HAZARIBAGH
2006,185,108,86,1650,1897,3926,JAMSHEDPUR
2006,5,4,0,389,177,575,JAMSHEDPUR RLY.
2006,50,42,30,220,546,888,JAMTARA
2006,56,42,38,282,556,974,KODERMA
2006,34,24,18,223,431,730,LATEHAR
2006,50,42,26,217,404,739,LOHARDAGGA
2006,161,56,38,194,473,922,PAKUR
2006,137,64,56,407,1168,1832,PALAMU
2006,313,158,188,2910,2964,6533,RANCHI
2006,79,106,44,251,583,1063,SAHEBGANJ
2006,129,34,28,250,643,1084,SARAIKELA
2006,106,58,18,126,291,599,SIMDEGA
2006,60,24,40,372,1736,2232,BAGALKOT
2006,542,66,198,17262,13910,31978,BANGALORE COMMR.
2006,279,52,68,2278,6921,9598,BANGALORE RURAL
2006,189,44,70,1223,4888,6414,BELGAUM
2006,100,30,46,730,3492,4398,BELLARY
2006,91,16,40,638,3024,3809,BIDAR
2006,122,36,52,465,2619,3294,BIJAPUR
2006,35,32,14,259,1146,1486,CHAMARAJNAGAR
2006,82,34,22,773,2728,3639,CHICKMAGALUR
2006,59,32,38,690,3039,3858,CHITRADURGA
2006,72,34,24,709,3460,4299,DAKSHIN KANNADA
2006,36,34,28,752,2234,3084,DAVANAGERE
2006,41,6,30,886,1494,2457,DHARWAD COMMR.
2006,43,8,16,136,921,1124,DHARWAD RURAL
2006,32,2,10,241,998,1283,GADAG
2006,224,36,90,791,4223,5364,GULBARGA
2006,99,26,22,823,3634,4604,HASSAN
2006,37,10,26,294,1622,1989,HAVERI
2006,40,6,16,262,623,947,K.G.F.
2006,60,12,12,203,1181,1468,KODAGU
2006,155,26,54,982,2641,3858,KOLAR
2006,34,12,14,259,1359,1678,KOPPAL
2006,104,38,28,772,3284,4226,MANDYA
2006,78,30,16,1310,1838,3272,MYSORE COMMR.
2006,103,20,16,523,2447,3109,MYSORE RURAL
2006,78,26,36,397,2331,2868,RAICHUR
2006,24,0,4,816,193,1037,RAILWAYS
2006,102,46,42,1027,3579,4796,SHIMOGA
2006,103,26,30,1048,3472,4679,TUMKUR
2006,31,22,14,361,1984,2412,UDUPI
2006,56,14,10,285,2041,2406,UTTAR KANNADA
2006,60,30,36,758,6776,7660,ALAPUZHA
2006,17,2,2,13,194,228,CBCID
2006,25,28,22,917,4770,5762,ERNAKULAM COMMR.
2006,44,50,28,936,7745,8803,ERNAKULAM RURAL
2006,38,60,28,650,4118,4894,IDUKKI
2006,49,74,32,716,4717,5588,KANNUR
2006,27,54,16,559,2557,3213,KASARGOD
2006,73,150,70,1652,8656,10601,KOLLAM
2006,39,60,44,1258,6746,8147,KOTTAYAM
2006,16,38,24,1060,2877,4015,KOZHIKODE COMMR.
2006,27,80,22,643,3821,4593,KOZHIKODE RURAL
2006,34,90,20,1240,5349,6733,MALAPPURAM
2006,74,118,16,813,4726,5747,PALAKKAD
2006,26,48,30,542,3805,4451,PATHANAMTHITTA
2006,0,0,0,313,142,455,RAILWAYS
2006,92,110,36,1213,8263,9714,THRISSUR
2006,42,56,56,1040,3863,5057,TRIVANDRUM COMMR.
2006,40,82,98,1325,7645,9190,TRIVANDRUM RURAL
2006,17,72,8,404,1960,2461,WAYANADU
2006,43,76,18,340,1173,1650,ANUPPUR
2006,66,108,16,451,1811,2452,ASHOK NAGAR
2006,82,134,10,376,1868,2470,BALAGHAT
2006,68,96,4,642,1854,2664,BARWANI
2006,89,284,54,674,2538,3639,BETUL
2006,175,68,26,705,3137,4111,BHIND
2006,151,140,98,4218,9907,14514,BHOPAL
2006,6,2,8,2107,426,2549,BHOPAL RLY.
2006,19,42,8,299,1083,1451,BURHANPUR
2006,143,118,46,757,3804,4868,CHHATARPUR
2006,114,250,32,735,3030,4161,CHHINDWARA
2006,96,80,8,405,2010,2599,DAMOH
2006,108,46,36,522,1844,2556,DATIYA
2006,115,170,42,1760,4033,6120,DEWAS
2006,123,206,70,1282,3650,5331,DHAR
2006,32,52,0,66,597,747,DINDORI
2006,82,138,26,693,2790,3729,GUNA
2006,259,154,82,4081,6878,11454,GWALIOR
2006,42,50,14,432,1008,1546,HARDA
2006,93,114,24,1062,2183,3476,HOSHANGABAD
2006,207,180,78,7720,11080,19265,INDORE
2006,3,6,0,284,213,506,INDORE RLY.
2006,197,206,78,2407,8045,10933,JABALPUR
2006,5,2,2,465,230,704,JABALPUR RLY.
2006,180,64,40,418,1837,2539,JHABUA
2006,82,64,14,535,2318,3013,KATNI
2006,85,120,42,1330,2840,4417,KHANDWA
2006,69,94,16,1494,2857,4530,KHARGON
2006,46,124,14,200,1312,1696,MANDLA
2006,43,74,36,950,2440,3543,MANDSAUR
2006,151,68,60,1035,4034,5348,MORENA
2006,73,130,8,282,1618,2111,NARSINGHPUR
2006,31,44,16,646,1396,2133,NEEMUCH
2006,61,82,16,261,1228,1648,PANNA
2006,97,148,28,657,3003,3933,RAISEN
2006,57,166,24,916,3587,4750,RAJGARH
2006,95,124,40,1021,2844,4124,RATLAM
2006,73,94,46,1373,3300,4886,REWA
2006,171,232,62,1458,5507,7430,SAGAR
2006,126,144,36,1349,4454,6109,SATNA
2006,59,114,12,362,2079,2626,SEONI
2006,55,134,8,576,1897,2670,SHAHDOL
2006,69,116,38,1485,2409,4117,SHAJAPUR
2006,25,38,16,281,1014,1374,SHEOPUR
2006,137,166,44,927,3692,4966,SHIVPURI
2006,97,132,62,960,3205,4456,SIDHI
2006,78,132,28,951,2573,3762,SIHORE
2006,68,104,18,528,2553,3271,TIKAMGARH
2006,193,158,78,2733,5312,8474,UJJAIN
2006,35,42,0,318,981,1376,UMARIYA
2006,105,170,34,939,2989,4237,VIDISHA
2006,135,136,72,3220,3887,7450,AHMEDNAGAR
2006,99,50,56,2339,2632,5176,AKOLA
2006,41,42,34,1701,1541,3359,AMRAVATI COMMR.
2006,99,88,44,1983,2420,4634,AMRAVATI RURAL
2006,55,66,44,1644,1552,3361,AURANGABAD COMMR.
2006,59,20,22,813,2010,2924,AURANGABAD RURAL
2006,109,48,68,2009,2888,5122,BEED
2006,53,80,30,1087,1831,3081,BHANDARA
2006,117,46,20,1663,2903,4749,BULDHANA
2006,62,60,34,1959,2357,4472,CHANDRAPUR
2006,71,24,16,876,1871,2858,DHULE
2006,111,28,20,368,920,1447,GADCHIROLI
2006,44,46,44,1053,1504,2691,GONDIA
2006,66,30,24,610,1351,2081,HINGOLI
2006,128,104,42,1541,3028,4843,JALGAON
2006,77,38,26,1153,2177,3471,JALNA
2006,110,66,58,1826,2267,4327,KOLHAPUR
2006,94,30,44,1117,3018,4303,LATUR
2006,374,330,380,26863,12693,40640,MUMBAI COMMR.
2006,16,10,10,3386,222,3644,MUMBAI RLY.
2006,136,102,116,6710,5283,12347,NAGPUR COMMR.
2006,10,0,4,1782,262,2058,NAGPUR RLY.
2006,98,74,48,2191,3007,5418,NAGPUR RURAL
2006,144,66,70,1472,3544,5296,NANDED
2006,40,42,18,389,995,1484,NANDURBAR
2006,52,28,64,2343,1355,3842,NASIK COMMR.
2006,117,124,56,1515,3473,5285,NASIK RURAL
2006,79,36,38,3022,1927,5102,NAVI MUMBAI
2006,85,74,20,1337,2186,3702,OSMANABAD
2006,116,36,36,836,1766,2790,PARBHANI
2006,203,154,216,9454,5092,15119,PUNE COMMR.
2006,3,2,2,472,143,622,PUNE RLY.
2006,186,76,80,2374,3669,6385,PUNE RURAL
2006,81,50,30,1215,1704,3080,RAIGAD
2006,23,50,18,755,1084,1930,RATNAGIRI
2006,95,48,42,1296,1604,3085,SANGLI
2006,104,68,82,2557,2833,5644,SATARA
2006,21,18,8,336,605,988,SINDHUDURG
2006,43,24,32,986,1038,2123,SOLAPUR COMMR.
2006,115,108,64,1343,2601,4231,SOLAPUR RURAL
2006,195,124,180,5938,3608,10045,THANE COMMR.
2006,198,136,70,2046,3087,5537,THANE RURAL
2006,77,62,44,1554,3015,4752,WARDHA
2006,47,24,22,832,1485,2410,WASHIM
2006,148,132,74,2417,3483,6254,YAVATMAL
2006,41,2,18,37,302,400,BISHNUPUR
2006,26,4,4,16,132,182,CHANDEL
2006,73,40,2,57,233,405,CHURACHANDPUR
2006,88,6,52,110,442,698,IMPHAL EAST
2006,115,18,102,355,710,1300,IMPHAL WEST
2006,20,0,12,40,162,234,SENAPATI
2006,14,0,0,13,123,150,TAMENGLONG
2006,88,10,70,42,377,587,THOUBAL
2006,5,0,0,2,149,156,UKHRUL
2006,26,6,12,81,149,274,GARO HILLS EAST
2006,5,0,8,47,116,176,GARO HILLS SOUTH
2006,22,20,26,103,220,391,GARO HILLS WEST
2006,54,38,6,107,237,442,JAINTIA HILLS
2006,61,60,56,689,371,1237,KHASI HILLS EAST
2006,17,12,2,68,147,246,KHASI HILLS WEST
2006,14,12,4,111,193,334,RI-BHOI
2006,16,62,4,1017,350,1449,AIZAWL
2006,2,24,0,189,128,343,CHAMPHAI
2006,5,16,4,182,216,423,KOLASIB
2006,3,2,0,51,148,204,LAWNGTLAI
2006,3,18,0,259,144,424,LUNGLEI
2006,9,4,2,55,118,188,MAMIT
2006,1,10,2,128,200,341,SAIHA
2006,5,8,0,74,116,203,SERCHHIP
2006,32,10,30,390,210,672,DIMAPUR
2006,1,0,0,2,111,114,KIPHIRE
2006,50,16,20,169,182,437,KOHIMA
2006,10,0,6,30,122,168,MOKOKCHUNG
2006,18,4,4,44,123,193,MON
2006,19,0,0,19,109,147,PEREN
2006,11,10,0,28,122,171,PHEK
2006,5,2,0,18,128,153,TUENSANG
2006,6,0,2,63,126,197,WOKHA
2006,17,4,0,61,124,206,ZUNHEBOTO
2006,82,82,32,805,1432,2433,ANGUL
2006,75,118,100,751,2194,3238,BALASORE
2006,65,34,26,370,899,1394,BARAGARH
2006,57,24,30,508,736,1355,BERHAMPUR
2006,71,90,40,278,1320,1799,BHADRAK
2006,61,80,74,412,1229,1856,BOLANGIR
2006,12,8,6,100,424,550,BOUDH
2006,44,92,112,1698,2627,4573,CUTTACK
2006,19,36,14,171,506,746,DEOGARH
2006,48,64,26,442,1159,1739,DHENKANAL
2006,14,14,16,102,405,551,GAJAPATI
2006,116,66,50,490,1382,2104,GANJAM
2006,29,24,42,371,931,1397,JAGATSINGHPUR
2006,63,70,78,577,1622,2410,JAJPUR
2006,35,26,10,472,969,1512,JHARSUGUDA
2006,44,98,30,268,1009,1449,KALAHANDI
2006,32,56,32,184,691,995,KANDHAMAL
2006,59,60,24,280,939,1362,KENDRAPARA
2006,143,106,70,534,1400,2253,KEONJHAR
2006,92,116,124,3097,3495,6924,KHURDA
2006,78,114,74,421,1012,1699,KORAPUT
2006,80,34,16,91,377,598,MALKANGIR
2006,126,176,76,617,1368,2363,MAYURBHANJ
2006,47,34,42,343,872,1338,NAYAGARH
2006,21,48,34,160,611,874,NOWRANGPUR
2006,17,18,12,187,582,816,NUAPADA
2006,38,38,66,890,1850,2882,PURI
2006,53,44,26,194,706,1023,RAYAGADA
2006,34,40,36,601,964,1675,ROURKELA
2006,102,50,26,837,1581,2596,SAMBALPUR
2006,31,26,12,131,354,554,SONEPUR
2006,5,2,10,633,238,888,SRP(CUTTACK)
2006,7,4,6,222,236,475,SRP(ROURKELA)
2006,111,78,36,516,1282,2023,SUNDARGARH
2006,88,26,50,866,786,1816,AMRITSAR
2006,21,10,12,99,449,591,BARNALA
2006,52,62,32,280,851,1277,BATALA
2006,109,38,54,447,876,1524,BHATINDA
2006,48,18,26,326,625,1043,FARIDKOT
2006,28,20,8,161,542,759,FATEHGARH SAHIB
2006,115,36,52,481,1151,1835,FEROZPUR
2006,14,2,0,103,319,438,G.R.P
2006,51,50,32,192,927,1252,GURDASPUR
2006,83,50,50,324,904,1411,HOSHIARPUR
2006,53,36,24,263,658,1034,JAGRAON
2006,202,104,250,1620,1915,4091,JALANDHAR
2006,57,26,42,394,773,1292,KAPURTHALA
2006,45,10,26,273,800,1154,KHANNA
2006,142,82,200,1267,1748,3439,LUDHIANA
2006,87,26,42,155,536,846,MAJITHA
2006,56,34,18,127,494,729,MANSA
2006,73,22,56,378,782,1311,MOGA
2006,46,28,34,259,504,871,MUKTSAR
2006,49,16,14,223,534,836,NAWAN SHAHR
2006,98,58,52,715,1678,2601,PATIALA
2006,13,16,20,126,581,756,ROPAR
2006,55,48,28,274,772,1177,SANGRUR
2006,59,20,30,814,1510,2433,SAS NGR
2006,71,46,30,269,560,976,TARN TARAN
2006,108,106,180,2099,4563,7056,AJMER
2006,158,162,204,2395,4923,7842,ALWAR
2006,51,54,76,278,2144,2603,BANSWARA
2006,111,74,88,599,1865,2737,BARAN
2006,44,24,52,491,2072,2683,BARMER
2006,135,70,164,1615,4643,6627,BHARATPUR
2006,97,80,194,1735,3046,5152,BHILWARA
2006,137,58,56,998,2673,3922,BIKANER
2006,74,78,128,520,2348,3148,BUNDI
2006,98,130,308,1462,4422,6420,CHITTORGARH
2006,40,34,38,366,1880,2358,CHURU
2006,42,32,70,1181,2775,4100,DAUSA
2006,100,56,82,682,2357,3277,DHOLPUR
2006,37,36,50,148,1425,1696,DUNGARPUR
2006,12,0,20,1109,526,1667,G.R.P.
2006,168,78,76,941,3434,4697,GANGANAGAR
2006,105,62,48,609,2203,3027,HANUMANGARH
2006,39,38,110,3571,2893,6651,JAIPUR EAST
2006,47,36,96,1841,2231,4251,JAIPUR NORTH
2006,97,68,170,1845,6084,8264,JAIPUR RURAL
2006,36,42,114,2500,2577,5269,JAIPUR SOUTH
2006,10,2,14,306,691,1023,JAISALMER
2006,43,20,46,390,1724,2223,JALORE
2006,108,84,132,849,2270,3443,JHALAWAR
2006,52,88,40,659,2905,3744,JHUNJHUNU
2006,57,36,74,1714,1935,3816,JODHPUR CITY
2006,64,38,42,507,2001,2652,JODHPUR RURAL
2006,50,58,118,770,2658,3654,KARAULI
2006,145,36,170,2016,2370,4737,KOTA CITY
2006,111,38,54,537,1527,2267,KOTA RURAL
2006,87,70,98,1002,3301,4558,NAGAUR
2006,81,60,136,969,3245,4491,PALI
2006,21,12,72,501,1981,2587,RAJSAMAND
2006,48,40,94,1061,2647,3890,SAWAI MADHOPUR
2006,79,58,120,842,3219,4318,SIKAR
2006,37,40,52,364,1431,1924,SIROHI
2006,48,24,112,757,3169,4110,TONK
2006,126,148,242,1399,4540,6455,UDAIPUR
2006,20,20,10,171,268,489,EAST
2006,2,6,0,12,124,144,NORTH
2006,8,10,4,101,208,331,SOUTH
2006,7,4,2,35,185,233,WEST
2006,324,58,118,5349,12233,18082,CHENNAI
2006,0,2,0,147,367,516,CHENNAI RLY.
2006,125,36,72,2116,6036,8385,COIMBATORE RURAL
2006,41,16,14,1991,2806,4868,COIMBATORE URBAN
2006,132,42,66,786,5474,6500,CUDDALORE
2006,67,18,32,297,2446,2860,DHARMAPURI
2006,80,22,80,848,4122,5152,DINDIGUL
2006,62,26,40,1145,5126,6399,ERODE
2006,99,24,32,876,4909,5940,KANCHIPURAM
2006,57,6,36,780,2530,3409,KANYAKUMARI
2006,32,10,28,535,2143,2748,KARUR
2006,88,28,58,913,3338,4425,KRISHNAGIRI
2006,69,56,120,765,3803,4813,MADURAI RURAL
2006,56,18,38,950,1821,2883,MADURAI URBAN
2006,72,18,36,542,3380,4048,NAGAPATTINAM
2006,44,12,36,442,2979,3513,NAMAKKAL
2006,39,10,4,323,1255,1631,NILGIRIS
2006,69,30,32,398,2269,2798,PERAMBALUR
2006,111,16,64,597,3307,4095,PUDUKOTTAI
2006,59,24,48,448,2468,3047,RAMNATHAPURAM
2006,79,42,90,387,3918,4516,SALEM RURAL
2006,32,14,26,631,2231,2934,SALEM URBAN
2006,61,10,46,406,2218,2741,SIVAGANGAI
2006,92,16,110,1257,3849,5324,THANJAVUR
2006,54,10,60,535,2483,3142,THENI
2006,204,84,62,890,5310,6550,THIRUNELVELI RURAL
2006,60,8,10,325,943,1346,THIRUNELVELI URBAN
2006,54,20,26,458,2790,3348,THIRUVALLUR
2006,65,20,32,411,2814,3342,THIRUVANNAMALAI
2006,48,14,34,502,2943,3541,THIRUVARUR
2006,140,26,26,963,3461,4616,THOOTHUGUDI
2006,2,2,0,49,174,227,TRICHY RLY.
2006,72,24,92,549,3361,4098,TRICHY RURAL
2006,36,6,42,929,2620,3633,TRICHY URBAN
2006,128,54,94,1119,6076,7471,VELLORE
2006,122,78,52,703,5896,6851,VILLUPURAM
2006,87,14,56,789,3587,4533,VIRUDHUNAGAR
2006,29,32,28,77,320,486,DHALAI
2006,53,90,52,255,594,1044,NORTH
2006,38,102,38,305,791,1274,SOUTH
2006,86,154,92,419,1172,1923,WEST
2006,313,52,350,3384,3252,7351,AGRA
2006,394,98,244,1727,2097,4560,ALIGARH
2006,225,44,150,1276,2371,4066,ALLAHABAD
2006,67,20,96,283,700,1166,AMBEDKAR NAGAR
2006,102,20,84,213,757,1176,AURAIYA
2006,122,26,42,457,1073,1720,AZAMGARH
2006,324,58,128,379,1244,2133,BADAUN
2006,156,24,86,387,744,1397,BAGHPAT
2006,94,42,88,344,920,1488,BAHRAICH
2006,88,20,22,262,574,966,BALLIA
2006,30,16,30,115,330,521,BALRAMPUR
2006,71,30,28,239,673,1041,BANDA
2006,135,42,104,432,1289,2002,BARABANKI
2006,369,90,186,1067,2562,4274,BAREILLY
2006,53,20,30,228,637,968,BASTI
2006,153,50,102,451,1013,1769,BIJNOR
2006,295,54,138,674,2027,3188,BULANDSHAHAR
2006,49,6,30,116,522,723,CHANDOLI
2006,44,26,14,113,339,536,CHITRAKOOT DHAM
2006,61,10,38,258,794,1161,DEORIA
2006,278,56,128,526,1289,2277,ETAH
2006,140,20,132,248,1149,1689,ETAWAH
2006,80,28,68,482,848,1506,FAIZABAD
2006,179,18,76,250,669,1192,FATEHGARH
2006,124,18,44,216,878,1280,FATEHPUR
2006,268,32,184,890,1369,2743,FIROZABAD
2006,40,2,14,1549,864,2469,G.R.P.
2006,154,52,104,2052,904,3266,GAUTAMBUDH NAGAR
2006,289,58,218,2381,2206,5152,GHAZIABAD
2006,90,16,28,260,555,949,GHAZIPUR
2006,118,44,88,446,764,1460,GONDA
2006,146,46,88,774,1469,2523,GORAKHPUR
2006,56,16,12,86,464,634,HAMIRPUR
2006,145,60,84,355,1297,1941,HARDOI
2006,158,46,90,536,949,1779,HATHRAS
2006,125,42,56,320,852,1395,J.P.NAGAR
2006,85,8,58,203,791,1145,JALAUN
2006,113,36,50,396,1315,1910,JAUNPUR
2006,65,16,24,294,582,981,JHANSI
2006,105,12,82,222,671,1092,KANNAUJ
2006,83,32,62,279,962,1418,KANPUR DEHAT
2006,241,54,234,1921,2894,5344,KANPUR NAGAR
2006,79,30,38,136,595,878,KAUSHAMBI
2006,201,78,136,421,1509,2345,KHIRI
2006,48,18,40,274,778,1158,KUSHI NAGAR
2006,25,14,24,114,398,575,LALITPUR
2006,352,102,410,5305,3775,9944,LUCKNOW
2006,33,42,44,142,538,799,MAHARAJGANJ
2006,57,6,18,93,388,562,MAHOBA
2006,230,32,84,407,1057,1810,MAINPURI
2006,225,60,114,1351,1826,3576,MATHURA
2006,76,14,48,305,618,1061,MAU
2006,394,74,216,2249,2016,4949,MEERUT
2006,77,28,36,254,582,977,MIRZAPUR
2006,289,88,188,1263,2362,4190,MORADABAD
2006,394,62,240,1442,1832,3970,MUZAFFARNAGAR
2006,70,26,54,153,1264,1567,PILIBHIT
2006,143,60,122,503,1211,2039,PRATAPGARH
2006,131,42,80,445,1125,1823,RAIBAREILLY
2006,122,22,86,545,926,1701,RAMPUR
2006,195,30,82,950,1822,3079,SAHARANPUR
2006,34,8,36,125,431,634,SANT KABIRNAGAR
2006,216,42,114,340,1057,1769,SHAHJAHANPUR
2006,22,12,42,95,362,533,SHRAWASTI
2006,21,8,56,229,607,921,SIDHARTHNAGAR
2006,239,94,156,891,1661,3041,SITAPUR
2006,52,16,8,112,411,599,SONBHADRA
2006,40,4,10,129,366,549,ST.RAVIDASNAGAR
2006,181,50,62,454,878,1625,SULTANPUR
2006,166,74,88,385,1095,1808,UNNAO
2006,138,32,90,1596,1485,3341,VARANASI
2006,25,22,10,96,206,359,ALMORA
2006,14,8,8,44,143,217,BAGESHWAR
2006,10,14,8,49,224,305,CHAMOLI
2006,12,6,2,38,168,226,CHAMPAWAT
2006,74,46,86,899,1247,2352,DEHRADUN
2006,111,64,128,1557,965,2825,HARIDWAR
2006,44,18,34,357,572,1025,NAINITAL
2006,26,8,16,146,269,465,PAURI GARHWAL
2006,16,16,6,72,256,366,PITHORAGARH
2006,7,6,4,44,178,239,RUDRA PRAYAG
2006,17,18,18,59,188,300,TEHRI GARHWAL
2006,127,46,92,631,1125,2021,UDHAMSINGH NAGAR
2006,6,22,12,60,217,317,UTTARKASHI
2006,236,348,372,3358,4991,9305,24 PARGANAS NORTH
2006,142,380,310,2461,5269,8562,24 PARGANAS SOUTH
2006,58,38,32,377,1440,1945,ASANSOL
2006,93,102,52,457,874,1578,BANKURA
2006,82,114,78,621,1107,2002,BIRBHUM
2006,103,128,82,1308,2818,4439,BURDWAN
2006,39,248,96,288,1263,1934,COOCHBEHAR
2006,67,64,98,211,842,1282,DAKSHIN DINAJPUR
2006,54,60,86,957,1065,2222,DARJEELING
2006,137,86,56,1215,2316,3810,HOOGHLY
2006,58,120,132,1371,2590,4271,HOWRAH
2006,12,0,6,1417,165,1600,HOWRAH G.R.P.
2006,126,236,112,1061,1643,3178,JALPAIGURI
2006,3,0,0,185,127,315,KHARAGPUR G.R.P.
2006,97,76,188,5365,5099,10825,KOLKATA
2006,121,148,96,878,1339,2582,MALDA
2006,134,448,236,1475,3266,5559,MURSHIDABAD
2006,117,316,304,1758,3099,5594,NADIA
2006,156,158,100,749,1941,3104,PASCHIM MIDNAPUR
2006,98,142,118,567,1840,2765,PURAB MIDNAPUR
2006,41,96,26,324,839,1326,PURULIA
2006,14,2,10,376,165,567,SEALDAH G.R.P.
2006,3,0,8,126,132,269,SILIGURI G.R.P.
2006,106,152,112,626,1431,2427,UTTAR DINAJPUR
2006,7,12,10,286,524,839,ANDAMAN
2006,1,0,0,3,120,124,NICOBAR
2006,33,38,130,2695,1333,4229,CHANDIGARH
2006,9,12,36,173,348,578,D and N HAVELI
2006,8,2,6,171,204,391,DAMAN
2006,1,4,0,24,131,160,DIU
2006,54,34,146,2167,2327,4728,CENTRAL
2006,81,122,236,4457,2785,7681,EAST
2006,7,2,22,1897,190,2118,GRP(RLY)
2006,3,0,16,330,223,572,IGI AIRPORT
2006,15,12,52,1573,1228,2880,NEW DELHI
2006,49,44,82,1521,1993,3689,NORTH
2006,127,186,394,2776,3318,6801,NORTH-EAST
2006,279,338,874,5988,6684,14163,NORTH-WEST
2006,135,174,430,8164,5552,14455,SOUTH
2006,97,158,322,3875,3872,8324,SOUTH-WEST
2006,10,0,0,4,122,136,STF
2006,129,176,310,4949,4115,9679,WEST
2006,2,0,0,36,163,201,LAKSHADWEEP
2006,4,2,10,207,736,959,KARAIKAL
2006,50,16,26,1002,3328,4422,PONDICHERRY
2007,173,92,166,1186,4420,6037,ADILABAD
2007,234,62,174,1439,3781,5690,ANANTAPUR
2007,201,62,204,2537,5068,8072,CHITTOOR
2007,143,64,152,1015,4365,5739,CUDDAPAH
2007,270,90,294,7136,8249,16039,CYBERABAD
2007,213,60,168,3170,5992,9603,EAST GODAVARI
2007,3,0,4,242,150,399,GUNTAKAL RLY.
2007,347,86,186,2530,6167,9316,GUNTUR
2007,268,116,296,10179,9374,20233,HYDERABAD CITY
2007,218,146,304,1926,6269,8863,KARIMNAGAR
2007,183,162,208,1397,4753,6703,KHAMMAM
2007,116,54,114,1216,4062,5562,KRISHNA
2007,243,72,170,1082,4631,6198,KURNOOL
2007,236,174,172,1823,4640,7045,MAHABOOBNAGAR
2007,223,102,130,1499,4546,6500,MEDAK
2007,190,138,174,1229,6472,8203,NALGONDA
2007,149,88,134,1688,4461,6520,NELLORE
2007,228,46,120,1307,3876,5577,NIZAMABAD
2007,141,80,148,1253,4364,5986,PRAKASHAM
2007,93,42,54,415,1747,2351,RANGA REDDY
2007,12,0,0,684,182,878,SECUNDERABAD RLY.
2007,36,60,38,564,3350,4048,SRIKAKULAM
2007,77,34,128,3010,3383,6632,VIJAYAWADA CITY
2007,4,0,0,591,166,761,VIJAYAWADA RLY.
2007,106,24,22,321,2902,3375,VISAKHA RURAL
2007,44,48,78,2834,3407,6411,VISAKHAPATNAM
2007,64,20,46,611,2741,3482,VIZIANAGARAM
2007,167,114,276,1687,5499,7743,WARANGAL
2007,168,104,234,2678,4998,8182,WEST GODAVARI
2007,9,14,4,94,187,308,CHANGLANG
2007,8,4,8,72,145,237,DIBANG VALLEY
2007,9,2,8,50,125,194,K/KUMEY
2007,6,2,8,74,147,237,KAMENG EAST
2007,2,2,2,63,159,228,KAMENG WEST
2007,18,10,24,108,203,363,LOHIT
2007,11,16,40,356,386,809,PAPUM PARE
2007,7,16,8,172,196,399,SIANG EAST
2007,3,10,0,55,134,202,SIANG UPPER
2007,7,6,12,110,213,348,SIANG WEST
2007,2,6,8,66,170,252,SUBANSIRI LOWER
2007,3,6,8,55,190,262,SUBANSIRI UPPER
2007,3,2,0,30,124,159,TAWANG
2007,8,0,6,51,155,220,TIRAP
2007,1,0,0,1,107,109,UPPER DIBANG VALLEY
2007,47,166,174,613,1442,2442,BARPETA
2007,40,14,38,78,306,476,BASKA
2007,17,80,90,303,860,1350,BONGAIGAON
2007,0,0,0,0,127,127,C.I.D.
2007,81,116,234,1226,2687,4344,CACHAR
2007,12,20,40,102,479,653,CHIRANG
2007,31,122,90,360,894,1497,DARRANG
2007,39,140,84,339,841,1443,DHEMAJI
2007,86,296,276,524,2355,3537,DHUBRI
2007,129,110,186,991,1106,2522,DIBRUGARH
2007,2,6,6,153,286,453,G.R.P.
2007,36,102,102,434,750,1424,GOALPARA
2007,103,128,156,688,808,1883,GOLAGHAT
2007,79,142,568,4435,863,6087,GUWAHATI CITY
2007,29,52,84,199,710,1074,HAILAKANDI
2007,60,90,140,708,1083,2081,JORHAT
2007,71,148,126,933,1464,2742,KAMRUP
2007,112,32,86,354,481,1065,KARBI ANGLONG
2007,48,98,80,459,821,1506,KARIMGANJ
2007,49,84,94,427,704,1358,KOKRAJHAR
2007,59,124,168,448,1265,2064,LAKHIMPUR
2007,31,130,114,328,918,1521,MORIGAON
2007,53,10,24,111,249,447,N.C.HILLS
2007,141,228,416,1134,2304,4223,NAGAON
2007,36,24,64,257,518,899,NALBARI
2007,5,2,0,19,146,172,R.P.O.
2007,121,106,108,745,1522,2602,SIBSAGAR
2007,118,140,160,1080,1851,3349,SONITPUR
2007,149,114,182,1197,1295,2937,TINSUKIA
2007,41,50,52,273,424,840,UDALGURI
2007,233,94,54,615,2183,3179,ARARIA
2007,31,16,8,133,496,684,ARWAL
2007,80,60,70,717,1879,2806,AURANGABAD
2007,45,76,116,373,1677,2287,BAGAHA
2007,68,148,68,360,1502,2146,BANKA
2007,245,50,170,794,2367,3626,BEGUSARAI
2007,69,46,34,483,2342,2974,BETTIAH
2007,78,24,50,471,1377,2000,BHABHUA
2007,177,50,152,1014,2118,3511,BHAGALPUR
2007,245,82,114,838,2146,3425,BHOJPUR
2007,111,26,64,423,1037,1661,BUXAR
2007,181,94,182,729,2491,3677,DARBHANGA
2007,327,56,118,1142,2299,3942,GAYA
2007,127,18,42,508,1999,2694,GOPALGANJ
2007,9,2,4,140,200,355,JAMALPUR RLY.
2007,81,92,62,300,1271,1806,JAMUI
2007,56,14,54,224,1156,1504,JEHANABAD
2007,121,298,270,421,1809,2919,KATIHAR
2007,6,4,14,507,268,799,KATIHAR RLY.
2007,118,42,88,223,1461,1932,KHAGARIA
2007,35,106,130,276,764,1311,KISHANGANJ
2007,53,62,72,266,996,1449,LAKHISARAI
2007,83,64,72,315,1181,1715,MADHEPURA
2007,252,94,142,562,2907,3957,MADHUBANI
2007,199,50,208,1084,3367,4908,MOTIHARI
2007,139,50,104,556,1565,2414,MUNGER
2007,169,154,338,2058,4015,6734,MUZAFFARPUR
2007,12,4,8,691,298,1013,MUZAFFARPUR RLY.
2007,164,28,210,946,2816,4164,NALANDA
2007,40,14,28,152,882,1116,NAUGACHIA
2007,178,76,58,303,1378,1993,NAWADAH
2007,432,148,626,4293,10362,15861,PATNA
2007,25,4,16,1096,293,1434,PATNA RLY.
2007,180,438,286,627,1548,3079,PURNEA
2007,296,46,58,727,2063,3190,ROHTAS
2007,173,34,70,362,1502,2141,SAHARSA
2007,283,108,196,799,2209,3595,SAMASTIPUR
2007,457,114,82,1065,2224,3942,SARAN
2007,38,8,22,164,694,926,SHEIKHPURA
2007,49,26,16,81,386,558,SHEOHAR
2007,69,24,104,626,2118,2941,SITAMARHI
2007,141,34,150,575,1786,2686,SIWAN
2007,117,86,68,434,1126,1831,SUPAUL
2007,155,46,262,927,2751,4141,VAISHALI
2007,48,92,4,92,547,783,BALRAMPUR
2007,136,122,44,2161,3861,6324,BILASPUR
2007,261,8,18,57,250,594,BIZAPUR
2007,186,16,12,198,522,934,DANTEWARA
2007,24,52,16,459,1283,1834,DHAMTARI
2007,123,238,70,2132,4301,6864,DURG
2007,2,2,2,380,191,577,GRP RAIPUR
2007,101,120,28,345,1554,2148,JAGDALPUR
2007,91,108,14,793,2027,3033,JANJGIR
2007,73,122,44,293,719,1251,JASHPUR
2007,25,58,6,278,992,1359,KABIRDHAM
2007,65,44,12,276,924,1321,KANKER
2007,58,62,10,753,1685,2568,KORBA
2007,72,132,16,553,1075,1848,KORIYA
2007,25,50,8,559,1089,1731,MAHASAMUND
2007,56,6,6,23,157,248,NARAYANPUR
2007,92,110,14,904,2011,3131,RAIGARH
2007,187,240,106,3128,5715,9376,RAIPUR
2007,69,108,32,734,2265,3208,RAJNANDGAON
2007,85,144,18,475,1099,1821,SARGUJA
2007,65,130,8,356,932,1491,SURAJPUR
2007,28,10,6,739,839,1622,NORTH GOA
2007,28,30,18,570,827,1473,SOUTH GOA
2007,144,74,426,9714,11110,21468,AHMEDABAD COMMR.
2007,46,12,96,1046,3321,4521,AHMEDABAD RURAL
2007,10,10,0,30,354,404,AHWA-DANG
2007,43,14,98,456,1969,2580,AMRELI
2007,33,20,118,1370,3026,4567,ANAND
2007,48,16,30,683,2097,2874,BHARUCH
2007,80,36,208,2184,4428,6936,BHAVNAGAR
2007,54,16,70,488,1385,2013,DAHOD
2007,31,24,48,1023,2349,3475,GANDHINAGAR
2007,58,10,70,615,5561,6314,HIMATNAGAR
2007,75,22,44,1018,6283,7442,JAMNAGAR
2007,61,26,112,1313,3952,5464,JUNAGADH
2007,50,20,70,938,4429,5507,KHEDA NORTH
2007,71,20,72,1519,4181,5863,KUTCH
2007,55,12,100,1680,3845,5692,MEHSANA
2007,17,12,8,74,839,950,NARMADA
2007,31,4,28,260,871,1194,NAVSARI
2007,75,38,110,1133,3953,5309,PALANPUR
2007,70,32,88,572,3196,3958,PANCHMAHAL
2007,32,12,86,995,2355,3480,PATAN
2007,8,2,16,164,881,1071,PORBANDAR
2007,53,8,92,1929,2746,4828,RAJKOT COMMR.
2007,53,50,116,962,3269,4450,RAJKOT RURAL
2007,139,48,234,5351,7596,13368,SURAT COMMR.
2007,70,8,36,456,1307,1877,SURAT RURAL
2007,38,34,58,657,2722,3509,SURENDRANAGAR
2007,46,16,94,3199,3119,6474,VADODARA COMMR.
2007,97,20,78,449,2503,3147,VADODARA RURAL
2007,50,16,10,584,1489,2149,VALSAD
2007,22,0,8,1686,409,2125,W.RLY
2007,51,46,30,1006,1570,2703,AMBALA
2007,84,34,64,1048,1750,2980,BHIWANI
2007,101,74,308,2955,2475,5913,FARIDABAD
2007,42,14,50,629,1093,1828,FATEHABAD
2007,21,4,14,876,743,1658,GRP
2007,151,80,222,5386,2718,8557,GURGAON
2007,103,42,94,1210,2076,3525,HISSAR
2007,100,28,60,646,1066,1900,JHAJJAR
2007,72,38,48,696,1076,1930,JIND
2007,47,28,32,642,1108,1857,KAITHAL
2007,75,94,52,1734,1876,3831,KARNAL
2007,46,42,36,1540,1457,3121,KURUKSHETRA
2007,42,20,50,497,1337,1946,MAHENDRAGARH
2007,78,88,56,501,1245,1968,MEWAT
2007,49,30,44,648,1204,1975,PALWAL
2007,21,22,50,545,919,1557,PANCHKULA
2007,55,68,66,1632,1323,3144,PANIPAT
2007,35,44,70,873,1680,2702,REWARI
2007,105,36,60,1187,1424,2812,ROHTAK
2007,51,46,42,885,1362,2386,SIRSA
2007,119,48,84,1164,1818,3233,SONIPAT
2007,55,50,70,932,1141,2248,YAMUNANAGAR
2007,5,12,22,218,982,1239,BILASPUR
2007,12,30,22,239,630,933,CHAMBA
2007,0,0,0,6,105,111,G.R.P.
2007,8,10,32,206,1014,1270,HAMIRPUR
2007,33,40,50,345,1935,2403,KANGRA
2007,7,18,2,55,247,329,KINNAUR
2007,13,44,24,212,891,1184,KULLU
2007,1,2,2,8,176,189,LAHAUL-SPITI
2007,21,60,50,322,1911,2364,MANDI
2007,30,54,56,627,1648,2415,SHIMLA
2007,20,14,24,186,692,936,SIRMAUR
2007,19,16,34,400,1348,1817,SOLAN
2007,15,18,24,265,809,1131,UNA
2007,36,32,130,392,913,1503,ANANTNAG
2007,15,10,26,98,351,500,AWANTIPORA
2007,126,62,204,517,933,1842,BARAMULLA
2007,26,12,20,147,589,794,BORDER DISTRICT
2007,23,34,144,453,909,1563,BUDGAM
2007,0,0,0,0,105,105,CRIME JAMMU
2007,0,0,0,0,104,104,CRIME SRINAGAR
2007,103,56,60,183,734,1136,DODA
2007,17,10,90,161,467,745,GANDERBAL
2007,42,30,44,142,310,568,HANDWARA
2007,93,50,104,949,2558,3754,JAMMU
2007,2,0,2,12,176,192,KARGIL
2007,39,30,36,221,1087,1413,KATHUA
2007,28,18,92,239,472,849,KULGAM
2007,82,8,76,172,468,806,KUPWARA
2007,7,4,6,48,325,390,LEH
2007,48,26,34,120,668,896,POONCH
2007,76,22,102,279,564,1043,PULWAMA
2007,2,0,0,28,114,144,RAILWAYS
2007,50,50,102,220,1333,1755,RAJOURI
2007,45,30,20,148,662,905,RAMBAN
2007,22,14,22,61,324,443,REASI
2007,79,54,184,1005,1580,2902,SRINAGAR
2007,26,24,18,166,866,1100,UDHAMPUR
2007,81,114,86,1417,1768,3466,BOKARO
2007,159,86,38,324,676,1283,CHAIBASA
2007,98,50,24,270,740,1182,CHATRA
2007,77,48,52,718,1308,2203,DEOGHAR
2007,136,82,174,1983,2262,4637,DHANBAD
2007,7,2,0,283,218,510,DHANBAD RLY.
2007,92,104,58,463,1156,1873,DUMKA
2007,98,34,40,201,824,1197,GARHWA
2007,173,92,70,768,1959,3062,GIRIDIH
2007,140,60,78,385,923,1586,GODDA
2007,196,120,68,259,597,1240,GUMLA
2007,150,82,56,1523,1501,3312,HAZARIBAGH
2007,159,130,78,2118,1917,4402,JAMSHEDPUR
2007,4,2,8,327,188,529,JAMSHEDPUR RLY.
2007,23,44,42,230,590,929,JAMTARA
2007,100,30,30,130,270,560,KHUNTI
2007,55,30,36,291,583,995,KODERMA
2007,56,20,28,206,454,764,LATEHAR
2007,50,64,42,232,431,819,LOHARDAGGA
2007,124,90,44,224,504,986,PAKUR
2007,98,58,72,449,1199,1876,PALAMU
2007,54,56,74,785,821,1790,RAMGARH
2007,281,106,176,2745,2784,6092,RANCHI
2007,105,128,64,178,636,1111,SAHEBGANJ
2007,81,36,46,338,672,1173,SARAIKELA
2007,96,42,40,165,285,628,SIMDEGA
2007,62,8,54,332,1746,2202,BAGALKOT
2007,510,124,238,17028,14382,32282,BANGALORE COMMR.
2007,219,58,86,2071,6945,9379,BANGALORE RURAL
2007,194,44,84,1201,5476,6999,BELGAUM
2007,113,28,34,621,3054,3850,BELLARY
2007,88,22,52,586,3086,3834,BIDAR
2007,77,34,60,482,2712,3365,BIJAPUR
2007,30,6,14,229,1247,1526,CHAMARAJNAGAR
2007,61,22,22,494,2430,3029,CHICKMAGALUR
2007,52,20,42,504,3531,4149,CHITRADURGA
2007,63,22,22,720,3263,4090,DAKSHIN KANNADA
2007,41,20,32,568,2345,3006,DAVANAGERE
2007,36,10,32,758,1455,2291,DHARWAD COMMR.
2007,43,14,12,117,935,1121,DHARWAD RURAL
2007,34,8,10,196,891,1139,GADAG
2007,181,70,108,785,4077,5221,GULBARGA
2007,89,26,30,779,3835,4759,HASSAN
2007,38,16,42,292,1801,2189,HAVERI
2007,35,14,14,241,723,1027,K.G.F.
2007,53,8,22,371,1364,1818,KODAGU
2007,128,38,70,937,3037,4210,KOLAR
2007,29,12,10,244,1476,1771,KOPPAL
2007,91,34,30,662,3708,4525,MANDYA
2007,64,26,38,1429,1981,3538,MYSORE COMMR.
2007,105,40,22,487,2759,3413,MYSORE RURAL
2007,75,38,46,407,2451,3017,RAICHUR
2007,21,0,4,760,173,958,RAILWAYS
2007,83,46,52,859,3515,4555,SHIMOGA
2007,115,34,50,1112,3824,5135,TUMKUR
2007,24,22,14,372,2148,2580,UDUPI
2007,35,8,14,240,2139,2436,UTTAR KANNADA
2007,56,50,32,952,7052,8142,ALAPUZHA
2007,9,4,0,4,163,180,CBCID
2007,31,46,20,936,5663,6696,ERNAKULAM COMMR.
2007,52,44,16,1015,8346,9473,ERNAKULAM RURAL
2007,46,56,18,627,4242,4989,IDUKKI
2007,61,68,32,854,5077,6092,KANNUR
2007,25,38,4,570,2924,3561,KASARGOD
2007,70,92,44,1277,7899,9382,KOLLAM
2007,34,50,40,1149,6471,7744,KOTTAYAM
2007,22,30,22,940,3112,4126,KOZHIKODE COMMR.
2007,22,50,28,751,3935,4786,KOZHIKODE RURAL
2007,51,82,26,1473,5774,7406,MALAPPURAM
2007,60,78,18,854,4549,5559,PALAKKAD
2007,33,38,38,574,4202,4885,PATHANAMTHITTA
2007,0,0,2,323,145,470,RAILWAYS
2007,88,96,54,1044,8780,10062,THRISSUR
2007,34,40,46,1516,4018,5654,TRIVANDRUM COMMR.
2007,50,108,52,1210,6459,7879,TRIVANDRUM RURAL
2007,25,54,18,396,1978,2471,WAYANADU
2007,26,98,12,368,1340,1844,ANUPPUR
2007,63,162,22,592,2131,2970,ASHOK NAGAR
2007,67,106,14,399,1901,2487,BALAGHAT
2007,77,110,20,711,1913,2831,BARWANI
2007,99,312,36,576,2346,3369,BETUL
2007,172,54,30,664,2313,3233,BHIND
2007,150,164,96,5746,10061,16217,BHOPAL
2007,9,2,0,1945,411,2367,BHOPAL RLY.
2007,27,24,2,339,1167,1559,BURHANPUR
2007,133,130,64,1075,3986,5388,CHHATARPUR
2007,87,232,28,765,3064,4176,CHHINDWARA
2007,90,60,28,452,2260,2890,DAMOH
2007,98,50,42,500,2032,2722,DATIYA
2007,102,168,54,1637,4358,6319,DEWAS
2007,136,164,44,1097,3534,4975,DHAR
2007,18,46,0,65,551,680,DINDORI
2007,67,160,6,772,2719,3724,GUNA
2007,209,148,136,4508,6388,11389,GWALIOR
2007,40,76,24,400,1135,1675,HARDA
2007,89,104,46,979,2403,3621,HOSHANGABAD
2007,262,204,98,7846,11645,20055,INDORE
2007,3,8,0,297,224,532,INDORE RLY.
2007,237,154,80,2734,8555,11760,JABALPUR
2007,3,2,0,465,249,719,JABALPUR RLY.
2007,160,70,28,372,1881,2511,JHABUA
2007,59,88,30,494,2424,3095,KATNI
2007,64,128,28,1111,2251,3582,KHANDWA
2007,94,126,24,1189,3155,4588,KHARGON
2007,35,94,12,251,1393,1785,MANDLA
2007,67,80,42,756,2587,3532,MANDSAUR
2007,139,78,76,1126,4126,5545,MORENA
2007,65,98,10,383,1951,2507,NARSINGHPUR
2007,27,40,22,779,1846,2714,NEEMUCH
2007,72,52,24,313,1468,1929,PANNA
2007,115,150,24,627,3051,3967,RAISEN
2007,83,200,44,1030,4370,5727,RAJGARH
2007,75,170,28,890,2944,4107,RATLAM
2007,70,132,50,1391,3526,5169,REWA
2007,181,230,64,1618,6530,8623,SAGAR
2007,136,168,54,1490,3894,5742,SATNA
2007,68,102,14,397,2168,2749,SEONI
2007,47,100,16,560,2009,2732,SHAHDOL
2007,81,134,30,1195,2768,4208,SHAJAPUR
2007,42,26,12,213,1050,1343,SHEOPUR
2007,134,182,58,901,3234,4509,SHIVPURI
2007,86,164,88,985,3581,4904,SIDHI
2007,80,112,34,819,2495,3540,SIHORE
2007,91,126,36,629,2850,3732,TIKAMGARH
2007,201,158,66,2464,5769,8658,UJJAIN
2007,25,74,4,260,927,1290,UMARIYA
2007,106,200,44,1074,3185,4609,VIDISHA
2007,172,110,74,3307,4317,7980,AHMEDNAGAR
2007,81,44,34,2123,2660,4942,AKOLA
2007,52,14,36,1671,1590,3363,AMRAVATI COMMR.
2007,87,116,52,1771,2433,4459,AMRAVATI RURAL
2007,64,36,58,1886,1827,3871,AURANGABAD COMMR.
2007,76,28,30,977,2311,3422,AURANGABAD RURAL
2007,119,46,96,1722,3145,5128,BEED
2007,40,38,14,1292,1750,3134,BHANDARA
2007,97,78,44,1535,2644,4398,BULDHANA
2007,82,70,50,2055,2650,4907,CHANDRAPUR
2007,72,30,10,958,1989,3059,DHULE
2007,100,22,16,435,941,1514,GADCHIROLI
2007,48,64,26,848,1305,2291,GONDIA
2007,45,18,16,447,1278,1804,HINGOLI
2007,132,104,54,1617,3151,5058,JALGAON
2007,74,34,34,923,1881,2946,JALNA
2007,112,60,32,1821,2493,4518,KOLHAPUR
2007,110,34,52,1217,2870,4283,LATUR
2007,346,348,358,26564,12420,40036,MUMBAI COMMR.
2007,9,2,2,3487,260,3760,MUMBAI RLY.
2007,133,100,132,6292,5225,11882,NAGPUR COMMR.
2007,5,0,4,1783,210,2002,NAGPUR RLY.
2007,95,78,48,1981,3057,5259,NAGPUR RURAL
2007,165,66,80,1423,3375,5109,NANDED
2007,51,28,6,505,1245,1835,NANDURBAR
2007,59,14,42,2552,1415,4082,NASIK COMMR.
2007,136,88,58,1416,3697,5395,NASIK RURAL
2007,67,34,32,4041,2104,6278,NAVI MUMBAI
2007,68,58,46,1175,2230,3577,OSMANABAD
2007,86,44,28,841,2046,3045,PARBHANI
2007,252,132,244,10996,5461,17085,PUNE COMMR.
2007,6,0,2,644,157,809,PUNE RLY.
2007,181,118,82,2679,4093,7153,PUNE RURAL
2007,65,58,26,1097,1580,2826,RAIGAD
2007,23,34,18,721,1107,1903,RATNAGIRI
2007,98,56,36,1254,1652,3096,SANGLI
2007,101,86,76,2410,2604,5277,SATARA
2007,20,18,8,372,570,988,SINDHUDURG
2007,46,24,32,803,995,1900,SOLAPUR COMMR.
2007,130,92,70,1667,2964,4923,SOLAPUR RURAL
2007,194,156,220,6306,4080,10956,THANE COMMR.
2007,167,134,92,2380,3282,6055,THANE RURAL
2007,81,62,52,1600,2872,4667,WARDHA
2007,41,28,38,940,1531,2578,WASHIM
2007,120,98,64,2326,3301,5909,YAVATMAL
2007,62,8,18,90,310,488,BISHNUPUR
2007,33,0,4,19,142,198,CHANDEL
2007,33,2,12,103,159,309,CHURACHANDPUR
2007,130,2,56,229,383,800,IMPHAL EAST
2007,191,14,128,532,697,1562,IMPHAL WEST
2007,32,2,16,39,179,268,SENAPATI
2007,7,0,4,10,128,149,TAMENGLONG
2007,113,12,54,94,403,676,THOUBAL
2007,16,0,8,22,139,185,UKHRUL
2007,19,8,12,92,169,300,GARO HILLS EAST
2007,7,2,4,35,123,171,GARO HILLS SOUTH
2007,19,8,32,157,201,417,GARO HILLS WEST
2007,45,52,6,150,236,489,JAINTIA HILLS
2007,40,64,44,687,413,1248,KHASI HILLS EAST
2007,20,16,4,70,142,252,KHASI HILLS WEST
2007,13,14,2,124,177,330,RI-BHOI
2007,29,70,6,1147,319,1571,AIZAWL
2007,7,24,0,162,140,333,CHAMPHAI
2007,10,24,2,214,187,437,KOLASIB
2007,7,6,0,74,162,249,LAWNGTLAI
2007,3,18,0,259,144,424,LUNGLEI
2007,3,2,0,76,116,197,MAMIT
2007,2,6,0,77,149,234,SAIHA
2007,3,16,0,69,121,209,SERCHHIP
2007,38,10,14,533,216,811,DIMAPUR
2007,4,0,0,5,115,124,KIPHIRE
2007,38,8,8,165,189,408,KOHIMA
2007,3,0,2,0,111,116,LONGLENG
2007,20,2,6,39,137,204,MOKOKCHUNG
2007,10,0,0,29,124,163,MON
2007,3,0,2,22,114,141,PEREN
2007,10,0,0,23,125,158,PHEK
2007,11,0,2,22,126,161,TUENSANG
2007,15,6,0,48,126,195,WOKHA
2007,9,0,0,34,127,170,ZUNHEBOTO
2007,125,76,74,926,1545,2746,ANGUL
2007,69,110,102,809,2036,3126,BALASORE
2007,88,36,28,449,1049,1650,BARAGARH
2007,52,8,16,392,675,1143,BERHAMPUR
2007,50,84,42,226,1431,1833,BHADRAK
2007,99,106,52,401,1336,1994,BOLANGIR
2007,14,18,10,81,447,570,BOUDH
2007,82,82,136,1922,2529,4751,CUTTACK
2007,49,26,16,139,493,723,DEOGARH
2007,112,70,52,510,1260,2004,DHENKANAL
2007,18,16,20,83,419,556,GAJAPATI
2007,193,68,54,495,1466,2276,GANJAM
2007,27,36,26,363,1069,1521,JAGATSINGHPUR
2007,52,50,64,580,1622,2368,JAJPUR
2007,48,22,32,658,962,1722,JHARSUGUDA
2007,45,60,46,275,960,1386,KALAHANDI
2007,44,64,28,146,734,1016,KANDHAMAL
2007,53,60,62,335,1184,1694,KENDRAPARA
2007,166,82,70,604,1107,2029,KEONJHAR
2007,115,106,158,3295,3497,7171,KHURDA
2007,76,82,64,390,1051,1663,KORAPUT
2007,49,24,18,79,340,510,MALKANGIR
2007,152,148,64,734,1599,2697,MAYURBHANJ
2007,57,42,70,297,1018,1484,NAYAGARH
2007,49,56,44,123,697,969,NOWRANGPUR
2007,30,10,28,153,641,862,NUAPADA
2007,53,86,34,971,2118,3262,PURI
2007,53,46,28,171,578,876,RAYAGADA
2007,38,30,18,549,1024,1659,ROURKELA
2007,76,54,30,789,1475,2424,SAMBALPUR
2007,28,32,24,122,364,570,SONEPUR
2007,2,0,4,432,212,650,SRP(CUTTACK)
2007,6,2,4,229,242,483,SRP(ROURKELA)
2007,145,86,84,567,1329,2211,SUNDARGARH
2007,89,42,96,1059,1148,2434,AMRITSAR
2007,55,20,62,172,553,862,AMRITSAR RURAL
2007,29,14,12,161,512,728,BARNALA
2007,61,30,38,354,651,1134,BATALA
2007,95,54,68,829,1132,2178,BHATINDA
2007,52,26,34,385,698,1195,FARIDKOT
2007,25,30,94,617,750,1516,FATEHGARH SAHIB
2007,96,66,66,535,1278,2041,FEROZPUR
2007,14,4,2,74,343,437,G.R.P
2007,36,60,52,311,797,1256,GURDASPUR
2007,82,54,50,529,1140,1855,HOSHIARPUR
2007,34,30,20,251,689,1024,JAGRAON
2007,181,108,226,1619,1993,4127,JALANDHAR
2007,62,44,44,533,919,1602,KAPURTHALA
2007,45,34,36,287,799,1201,KHANNA
2007,139,116,240,1643,1843,3981,LUDHIANA
2007,59,40,16,167,610,892,MANSA
2007,71,14,44,326,718,1173,MOGA
2007,59,22,44,274,572,971,MUKTSAR
2007,41,26,20,276,590,953,NAWAN SHAHR
2007,106,44,50,812,1682,2694,PATIALA
2007,21,14,18,300,673,1026,ROPAR
2007,94,62,52,567,1110,1885,SANGRUR
2007,32,32,66,772,967,1869,SAS NGR
2007,75,52,70,376,731,1304,TARN TARAN
2007,124,62,178,2031,4659,7054,AJMER
2007,151,146,218,2705,5559,8779,ALWAR
2007,52,78,92,288,1857,2367,BANSWARA
2007,135,86,56,651,1749,2677,BARAN
2007,53,38,58,462,2091,2702,BARMER
2007,117,124,224,1678,5224,7367,BHARATPUR
2007,80,96,132,1467,3196,4971,BHILWARA
2007,124,64,72,772,3033,4065,BIKANER
2007,83,56,114,545,2185,2983,BUNDI
2007,96,184,294,1530,4622,6726,CHITTORGARH
2007,49,54,54,432,2037,2626,CHURU
2007,52,32,134,1567,3005,4790,DAUSA
2007,112,40,114,873,2663,3802,DHOLPUR
2007,40,20,84,176,1734,2054,DUNGARPUR
2007,9,0,12,972,548,1541,G.R.P.
2007,134,132,112,986,3635,4999,GANGANAGAR
2007,169,78,48,497,2056,2848,HANUMANGARH
2007,45,50,130,5056,3183,8464,JAIPUR EAST
2007,44,46,152,1845,2213,4300,JAIPUR NORTH
2007,91,78,170,2467,6428,9234,JAIPUR RURAL
2007,39,28,130,2920,2628,5745,JAIPUR SOUTH
2007,8,8,26,320,789,1151,JAISALMER
2007,43,14,60,388,1928,2433,JALORE
2007,148,108,98,902,1890,3146,JHALAWAR
2007,60,62,68,757,3132,4079,JHUNJHUNU
2007,73,32,110,1659,1952,3826,JODHPUR CITY
2007,53,48,38,581,2172,2892,JODHPUR RURAL
2007,88,56,138,907,2810,3999,KARAULI
2007,176,50,168,1996,1929,4319,KOTA CITY
2007,62,60,66,530,1234,1952,KOTA RURAL
2007,88,76,98,965,2857,4084,NAGAUR
2007,66,78,142,899,3646,4831,PALI
2007,29,10,86,447,1897,2469,RAJSAMAND
2007,40,42,96,998,2672,3848,SAWAI MADHOPUR
2007,71,68,118,868,3057,4182,SIKAR
2007,43,46,74,405,1452,2020,SIROHI
2007,59,38,120,635,2851,3703,TONK
2007,169,188,270,1607,5035,7269,UDAIPUR
2007,12,16,10,180,250,468,EAST
2007,0,0,0,14,126,140,NORTH
2007,3,24,2,76,211,316,SOUTH
2007,8,8,6,55,176,253,WEST
2007,392,92,166,4970,12679,18299,CHENNAI
2007,9,0,6,235,325,575,CHENNAI RLY.
2007,149,32,168,2408,12543,15300,COIMBATORE RURAL
2007,37,20,28,1504,3034,4623,COIMBATORE URBAN
2007,175,56,114,1129,6054,7528,CUDDALORE
2007,84,12,88,294,3162,3640,DHARMAPURI
2007,119,24,100,676,3878,4797,DINDIGUL
2007,85,40,132,1354,6390,8001,ERODE
2007,154,50,36,913,6539,7692,KANCHIPURAM
2007,78,22,44,709,3668,4521,KANYAKUMARI
2007,35,6,28,389,2436,2894,KARUR
2007,116,22,76,658,4032,4904,KRISHNAGIRI
2007,107,18,72,601,4152,4950,MADURAI RURAL
2007,52,8,46,744,1743,2593,MADURAI URBAN
2007,104,28,56,472,3985,4645,NAGAPATTINAM
2007,45,24,62,517,3510,4158,NAMAKKAL
2007,21,12,10,274,1234,1551,NILGIRIS
2007,67,52,44,403,2565,3131,PERAMBALUR
2007,63,28,50,582,3029,3752,PUDUKOTTAI
2007,92,16,50,441,2663,3262,RAMNATHAPURAM
2007,121,50,142,490,4655,5458,SALEM RURAL
2007,46,20,56,418,1240,1780,SALEM URBAN
2007,93,6,80,534,2475,3188,SIVAGANGAI
2007,134,10,100,1339,5531,7114,THANJAVUR
2007,91,8,44,597,3221,3961,THENI
2007,342,70,112,1049,6457,8030,THIRUNELVELI RURAL
2007,63,12,20,438,1131,1664,THIRUNELVELI URBAN
2007,58,14,28,367,2766,3233,THIRUVALLUR
2007,71,28,50,460,4311,4920,THIRUVANNAMALAI
2007,83,18,60,489,3907,4557,THIRUVARUR
2007,162,38,66,989,3838,5093,THOOTHUGUDI
2007,0,0,0,62,163,225,TRICHY RLY.
2007,68,24,46,435,3277,3850,TRICHY RURAL
2007,43,4,34,1119,2568,3768,TRICHY URBAN
2007,102,50,110,1012,6588,7862,VELLORE
2007,146,116,128,857,6138,7385,VILLUPURAM
2007,104,16,88,839,3322,4369,VIRUDHUNAGAR
2007,21,26,54,87,312,500,DHALAI
2007,27,52,42,186,572,879,NORTH
2007,69,82,42,330,887,1410,SOUTH
2007,79,154,88,492,1395,2208,WEST
2007,264,60,418,3247,3360,7349,AGRA
2007,320,100,294,1551,2081,4346,ALIGARH
2007,228,52,200,1480,2926,4886,ALLAHABAD
2007,46,30,66,311,759,1212,AMBEDKAR NAGAR
2007,71,18,68,218,858,1233,AURAIYA
2007,77,22,68,318,979,1464,AZAMGARH
2007,198,22,106,363,1325,2014,BADAUN
2007,138,34,70,369,740,1351,BAGHPAT
2007,73,68,106,358,872,1477,BAHRAICH
2007,63,20,52,268,570,973,BALLIA
2007,33,20,34,147,406,640,BALRAMPUR
2007,71,30,36,218,714,1069,BANDA
2007,106,50,140,434,1404,2134,BARABANKI
2007,309,124,252,1199,3290,5174,BAREILLY
2007,44,20,44,234,861,1203,BASTI
2007,150,54,136,434,1420,2194,BIJNOR
2007,306,88,240,897,2765,4296,BULANDSHAHAR
2007,37,12,24,152,770,995,CHANDOLI
2007,37,46,16,109,351,559,CHITRAKOOT DHAM
2007,48,4,42,212,817,1123,DEORIA
2007,335,78,214,703,1708,3038,ETAH
2007,135,28,168,526,1618,2475,ETAWAH
2007,81,46,92,519,967,1705,FAIZABAD
2007,154,42,142,275,961,1574,FATEHGARH
2007,96,44,90,228,1057,1515,FATEHPUR
2007,266,56,218,828,1625,2993,FIROZABAD
2007,40,4,16,2597,814,3471,G.R.P.
2007,146,34,166,2887,1235,4468,GAUTAMBUDH NAGAR
2007,285,66,316,2230,2159,5056,GHAZIABAD
2007,79,20,28,287,815,1229,GHAZIPUR
2007,92,26,94,415,781,1408,GONDA
2007,133,38,116,801,1312,2400,GORAKHPUR
2007,29,16,24,36,395,500,HAMIRPUR
2007,140,66,94,379,1288,1967,HARDOI
2007,110,32,142,535,1240,2059,HATHRAS
2007,116,56,68,391,789,1420,J.P.NAGAR
2007,65,16,54,206,927,1268,JALAUN
2007,106,48,94,447,1601,2296,JAUNPUR
2007,96,20,50,421,754,1341,JHANSI
2007,94,12,64,190,829,1189,KANNAUJ
2007,84,26,124,283,1397,1914,KANPUR DEHAT
2007,280,92,582,2833,4884,8671,KANPUR NAGAR
2007,74,60,96,229,850,1309,KAUSHAMBI
2007,159,94,150,648,1534,2585,KHIRI
2007,40,18,58,185,890,1191,KUSHI NAGAR
2007,26,20,26,117,516,705,LALITPUR
2007,277,164,520,6156,4699,11816,LUCKNOW
2007,36,46,50,144,902,1178,MAHARAJGANJ
2007,43,20,22,136,387,608,MAHOBA
2007,245,22,144,679,1353,2443,MAINPURI
2007,198,72,148,1361,2445,4224,MATHURA
2007,70,16,74,262,615,1037,MAU
2007,384,78,300,1969,2296,5027,MEERUT
2007,57,20,16,243,579,915,MIRZAPUR
2007,268,116,258,1354,2799,4795,MORADABAD
2007,383,74,308,1242,2198,4205,MUZAFFARNAGAR
2007,58,46,94,188,1286,1672,PILIBHIT
2007,102,32,106,466,1190,1896,PRATAPGARH
2007,103,62,94,432,1260,1951,RAIBAREILLY
2007,128,80,122,638,1343,2311,RAMPUR
2007,186,28,82,884,1985,3165,SAHARANPUR
2007,31,18,40,99,420,608,SANT KABIRNAGAR
2007,251,104,204,639,1687,2885,SHAHJAHANPUR
2007,30,20,36,147,298,531,SHRAWASTI
2007,16,10,50,201,601,878,SIDHARTHNAGAR
2007,193,134,204,1070,1719,3320,SITAPUR
2007,51,32,24,168,565,840,SONBHADRA
2007,32,2,26,176,373,609,ST.RAVIDASNAGAR
2007,120,68,100,537,1001,1826,SULTANPUR
2007,155,60,136,409,1006,1766,UNNAO
2007,127,40,100,2062,2134,4463,VARANASI
2007,28,12,0,131,267,438,ALMORA
2007,11,6,0,26,169,212,BAGESHWAR
2007,24,20,14,81,208,347,CHAMOLI
2007,5,4,4,36,151,200,CHAMPAWAT
2007,87,58,120,974,1220,2459,DEHRADUN
2007,114,56,144,1138,1412,2864,HARIDWAR
2007,45,12,50,410,626,1143,NAINITAL
2007,26,14,22,128,376,566,PAURI GARHWAL
2007,11,18,18,108,316,471,PITHORAGARH
2007,12,2,10,60,165,249,RUDRA PRAYAG
2007,18,4,8,97,239,366,TEHRI GARHWAL
2007,110,24,98,692,1272,2196,UDHAMSINGH NAGAR
2007,5,4,18,78,242,347,UTTARKASHI
2007,200,462,472,2649,6724,10507,24 PARGANAS NORTH
2007,281,410,482,3276,5925,10374,24 PARGANAS SOUTH
2007,28,30,36,366,1227,1687,ASANSOL
2007,81,88,28,367,995,1559,BANKURA
2007,81,106,62,594,1367,2210,BIRBHUM
2007,136,138,108,1117,3357,4856,BURDWAN
2007,44,278,136,346,1551,2355,COOCHBEHAR
2007,112,92,94,199,955,1452,DAKSHIN DINAJPUR
2007,33,96,72,1000,1239,2440,DARJEELING
2007,187,114,92,1410,2528,4331,HOOGHLY
2007,85,90,166,1360,2967,4668,HOWRAH
2007,13,2,6,815,157,993,HOWRAH G.R.P.
2007,178,470,404,3181,4117,8350,JALPAIGURI
2007,3,0,4,257,137,401,KHARAGPUR G.R.P.
2007,107,88,228,6101,6011,12535,KOLKATA
2007,151,206,146,596,1473,2572,MALDA
2007,193,738,280,1399,3523,6133,MURSHIDABAD
2007,168,366,350,1809,3783,6476,NADIA
2007,144,120,122,760,2144,3290,PASCHIM MIDNAPUR
2007,117,82,150,521,2571,3441,PURAB MIDNAPUR
2007,46,76,28,397,1074,1621,PURULIA
2007,13,6,8,344,160,531,SEALDAH G.R.P.
2007,5,2,2,116,132,257,SILIGURI G.R.P.
2007,123,152,124,636,1419,2454,UTTAR DINAJPUR
2007,34,6,24,328,594,986,A and N ISLANDS
2007,45,44,104,3710,1410,5313,CHANDIGARH
2007,12,14,18,206,355,605,D and N HAVELI
2007,18,2,0,120,201,341,DAMAN
2007,1,0,2,18,140,161,DIU
2007,56,44,140,2237,1802,4279,CENTRAL
2007,95,146,290,4810,2880,8221,EAST
2007,3,8,24,1601,187,1823,GRP(RLY)
2007,1,0,6,295,188,490,IGI AIRPORT
2007,11,14,24,1473,1157,2679,NEW DELHI
2007,63,66,128,1627,2131,4015,NORTH
2007,140,178,482,2848,2942,6590,NORTH-EAST
2007,109,102,416,4043,2418,7088,NORTH-WEST
2007,198,242,720,2765,3331,7256,OUTER
2007,152,166,512,6957,5619,13406,SOUTH
2007,94,102,296,3970,4176,8638,SOUTH-WEST
2007,6,0,0,2,129,137,STF
2007,97,128,338,4321,3485,8369,WEST
2007,2,2,0,42,133,179,LAKSHADWEEP
2007,13,6,10,189,707,925,KARAIKAL
2007,63,12,30,1482,3424,5011,PONDICHERRY
2008,155,100,82,1125,4120,5582,ADILABAD
2008,234,74,180,1244,4460,6192,ANANTAPUR
2008,188,60,168,2928,5067,8411,CHITTOOR
2008,208,54,152,1237,5205,6856,CUDDAPAH
2008,263,160,282,7569,7886,16160,CYBERABAD
2008,194,96,182,2822,5941,9235,EAST GODAVARI
2008,7,0,0,245,137,389,GUNTAKAL RLY.
2008,355,96,166,2835,6185,9637,GUNTUR
2008,248,124,280,11668,9499,21819,HYDERABAD CITY
2008,248,168,318,1705,6059,8498,KARIMNAGAR
2008,170,140,206,1388,4376,6280,KHAMMAM
2008,116,76,138,1351,4264,5945,KRISHNA
2008,259,94,178,1354,5992,7877,KURNOOL
2008,254,144,208,2147,4730,7483,MAHABOOBNAGAR
2008,197,100,124,1606,4430,6457,MEDAK
2008,197,180,182,1419,6396,8374,NALGONDA
2008,143,78,166,1764,4538,6689,NELLORE
2008,214,62,102,1748,4099,6225,NIZAMABAD
2008,134,60,132,1016,4277,5619,PRAKASHAM
2008,126,74,46,520,1874,2640,RANGA REDDY
2008,10,4,0,744,190,948,SECUNDERABAD RLY.
2008,25,64,36,591,3404,4120,SRIKAKULAM
2008,92,60,98,2566,3187,6003,VIJAYAWADA CITY
2008,2,0,2,616,204,824,VIJAYAWADA RLY.
2008,105,24,24,412,2674,3239,VISAKHA RURAL
2008,68,58,68,2384,3263,5841,VISAKHAPATNAM
2008,50,12,32,560,2624,3278,VIZIANAGARAM
2008,194,118,164,1177,5258,6911,WARANGAL
2008,176,234,224,3059,5377,9070,WEST GODAVARI
2008,10,4,8,124,203,349,CHANGLANG
2008,3,6,12,84,163,268,DIBANG VALLEY
2008,7,4,6,14,175,206,K/KUMEY
2008,4,10,12,47,197,270,KAMENG EAST
2008,1,0,6,51,158,216,KAMENG WEST
2008,12,6,2,105,184,309,LOHIT
2008,17,14,36,322,349,738,PAPUM PARE
2008,11,10,16,118,169,324,SIANG EAST
2008,4,0,2,33,126,165,SIANG UPPER
2008,11,26,20,127,259,443,SIANG WEST
2008,5,0,8,50,183,246,SUBANSIRI LOWER
2008,10,4,4,35,220,273,SUBANSIRI UPPER
2008,2,0,0,24,125,151,TAWANG
2008,10,0,26,85,155,276,TIRAP
2008,2,0,0,9,110,121,UPPER DIBANG VALLEY
2008,74,194,256,575,1913,3012,BARPETA
2008,86,46,70,90,343,635,BASKA
2008,25,102,120,395,868,1510,BONGAIGAON
2008,0,0,0,2,117,119,C.I.D.
2008,62,144,256,1609,3605,5676,CACHAR
2008,24,50,66,147,376,663,CHIRANG
2008,43,114,118,385,979,1639,DARRANG
2008,51,176,132,359,935,1653,DHEMAJI
2008,64,232,278,637,2407,3618,DHUBRI
2008,120,92,178,1294,1357,3041,DIBRUGARH
2008,6,10,16,327,159,518,G.R.P.
2008,41,132,152,359,950,1634,GOALPARA
2008,80,84,122,623,929,1838,GOLAGHAT
2008,68,118,334,2961,4684,8165,GUWAHATI CITY
2008,27,78,122,339,887,1453,HAILAKANDI
2008,75,88,108,664,919,1854,JORHAT
2008,69,72,226,1764,1069,3200,KAMRUP
2008,71,32,50,334,454,941,KARBI ANGLONG
2008,40,38,98,278,837,1291,KARIMGANJ
2008,85,110,102,398,540,1235,KOKRAJHAR
2008,47,104,182,457,1473,2263,LAKHIMPUR
2008,29,150,136,420,995,1730,MORIGAON
2008,56,8,28,103,199,394,N.C.HILLS
2008,124,224,430,1059,2895,4732,NAGAON
2008,60,60,110,409,814,1453,NALBARI
2008,3,10,6,32,160,211,R.P.O.
2008,115,92,222,1181,1299,2909,SIBSAGAR
2008,125,112,272,1096,1813,3418,SONITPUR
2008,114,120,174,1517,1243,3168,TINSUKIA
2008,59,84,114,311,582,1150,UDALGURI
2008,87,74,80,625,2337,3203,ARARIA
2008,28,4,24,130,651,837,ARWAL
2008,119,60,112,782,2600,3673,AURANGABAD
2008,34,30,98,523,2065,2750,BAGAHA
2008,126,98,92,410,1404,2130,BANKA
2008,271,50,220,705,2364,3610,BEGUSARAI
2008,97,56,102,569,2805,3629,BETTIAH
2008,78,16,74,474,1374,2016,BHABHUA
2008,171,70,266,1572,3017,5096,BHAGALPUR
2008,305,36,144,787,2799,4071,BHOJPUR
2008,113,22,52,654,1004,1845,BUXAR
2008,230,134,246,742,2724,4076,DARBHANGA
2008,196,104,180,1210,3023,4713,GAYA
2008,167,46,160,395,2086,2854,GOPALGANJ
2008,10,2,8,258,176,454,JAMALPUR RLY.
2008,183,34,76,357,1355,2005,JAMUI
2008,45,12,76,322,1331,1786,JEHANABAD
2008,76,240,206,409,2288,3219,KATIHAR
2008,17,4,18,486,271,796,KATIHAR RLY.
2008,118,32,96,238,1577,2061,KHAGARIA
2008,74,60,66,409,1034,1643,KISHANGANJ
2008,108,70,68,332,843,1421,LAKHISARAI
2008,41,32,90,362,1428,1953,MADHEPURA
2008,134,48,102,829,4626,5739,MADHUBANI
2008,426,68,242,1138,3344,5218,MOTIHARI
2008,177,40,122,710,1303,2352,MUNGER
2008,149,56,272,2052,4067,6596,MUZAFFARPUR
2008,16,4,8,632,346,1006,MUZAFFARPUR RLY.
2008,173,46,200,909,3309,4637,NALANDA
2008,48,16,58,139,1310,1571,NAUGACHIA
2008,84,56,96,365,1391,1992,NAWADAH
2008,530,114,682,3932,10767,16025,PATNA
2008,37,0,22,1226,338,1623,PATNA RLY.
2008,101,370,278,712,1712,3173,PURNEA
2008,131,42,126,1069,3052,4420,ROHTAS
2008,169,44,82,383,1588,2266,SAHARSA
2008,373,64,148,884,2418,3887,SAMASTIPUR
2008,256,68,196,1102,2445,4067,SARAN
2008,49,18,50,186,900,1203,SHEIKHPURA
2008,26,14,38,114,501,693,SHEOHAR
2008,109,24,140,760,2644,3677,SITAMARHI
2008,139,48,134,638,1791,2750,SIWAN
2008,137,106,108,475,1352,2178,SUPAUL
2008,135,72,436,1158,2585,4386,VAISHALI
2008,61,82,14,138,616,911,BALRAMPUR
2008,160,142,66,2411,4379,7158,BILASPUR
2008,177,10,16,33,246,482,BIZAPUR
2008,153,20,16,167,511,867,DANTEWARA
2008,39,52,8,470,1201,1770,DHAMTARI
2008,122,218,36,2304,4662,7342,DURG
2008,6,4,0,401,185,596,GRP RAIPUR
2008,119,136,26,392,1878,2551,JAGDALPUR
2008,67,94,16,945,2203,3325,JANJGIR
2008,81,142,92,371,859,1545,JASHPUR
2008,29,58,10,418,1378,1893,KABIRDHAM
2008,107,30,20,257,818,1232,KANKER
2008,50,62,24,774,1947,2857,KORBA
2008,70,108,10,544,1274,2006,KORIYA
2008,32,48,16,436,1164,1696,MAHASAMUND
2008,67,2,2,26,167,264,NARAYANPUR
2008,113,60,20,1163,2059,3415,RAIGARH
2008,203,256,92,3968,6819,11338,RAIPUR
2008,80,120,24,853,2520,3597,RAJNANDGAON
2008,92,156,18,443,1327,2036,SARGUJA
2008,77,156,20,397,1055,1705,SURAJPUR
2008,40,30,38,880,889,1877,NORTH GOA
2008,34,30,34,650,797,1545,SOUTH GOA
2008,145,88,344,12302,10969,23848,AHMEDABAD COMMR.
2008,56,6,72,874,2823,3831,AHMEDABAD RURAL
2008,9,6,4,28,300,347,AHWA-DANG
2008,28,16,120,570,1957,2691,AMRELI
2008,50,22,102,1165,3028,4367,ANAND
2008,51,26,68,934,2414,3493,BHARUCH
2008,68,18,180,2001,4466,6733,BHAVNAGAR
2008,65,26,86,521,1389,2087,DAHOD
2008,44,16,88,1402,3943,5493,GANDHINAGAR
2008,51,32,74,525,4481,5163,HIMATNAGAR
2008,46,34,60,1006,4681,5827,JAMNAGAR
2008,53,10,96,1721,4088,5968,JUNAGADH
2008,47,16,82,918,4648,5711,KHEDA NORTH
2008,48,32,88,1648,3831,5647,KUTCH
2008,47,18,108,1558,3575,5306,MEHSANA
2008,14,14,14,95,811,948,NARMADA
2008,28,4,18,199,924,1173,NAVSARI
2008,58,74,86,1072,3326,4616,PALANPUR
2008,53,16,110,531,2899,3609,PANCHMAHAL
2008,29,38,58,866,2414,3405,PATAN
2008,13,6,24,222,937,1202,PORBANDAR
2008,70,24,108,3185,3515,6902,RAJKOT COMMR.
2008,61,48,94,1045,3121,4369,RAJKOT RURAL
2008,139,56,262,6816,6506,13779,SURAT COMMR.
2008,47,6,22,299,1411,1785,SURAT RURAL
2008,50,42,88,485,2551,3216,SURENDRANAGAR
2008,26,6,6,109,600,747,TAPI
2008,52,14,68,3230,3424,6788,VADODARA COMMR.
2008,96,22,78,451,2381,3028,VADODARA RURAL
2008,38,8,30,589,1410,2075,VALSAD
2008,11,4,8,1708,362,2093,W.RLY
2008,62,70,110,1124,1660,3026,AMBALA
2008,83,66,94,1399,1695,3337,BHIWANI
2008,83,92,218,2253,2876,5522,FARIDABAD
2008,33,24,50,733,1127,1967,FATEHABAD
2008,30,2,14,1019,784,1849,GRP
2008,139,70,178,6587,2944,9918,GURGAON
2008,98,46,86,1366,2146,3742,HISSAR
2008,92,44,52,705,1157,2050,JHAJJAR
2008,63,76,58,770,1133,2100,JIND
2008,46,28,32,513,1123,1742,KAITHAL
2008,85,100,70,1666,2055,3976,KARNAL
2008,39,82,60,1437,1444,3062,KURUKSHETRA
2008,37,42,52,499,1385,2015,MAHENDRAGARH
2008,40,58,42,485,942,1567,MEWAT
2008,71,58,64,823,1424,2440,PALWAL
2008,24,30,52,1032,927,2065,PANCHKULA
2008,62,60,104,1934,1505,3665,PANIPAT
2008,51,46,54,1062,1634,2847,REWARI
2008,120,78,64,1459,1582,3303,ROHTAK
2008,83,62,50,825,1368,2388,SIRSA
2008,132,72,118,1655,2122,4099,SONIPAT
2008,64,56,86,1253,1247,2706,YAMUNANAGAR
2008,7,20,14,176,961,1178,BILASPUR
2008,13,20,32,217,629,911,CHAMBA
2008,0,0,0,6,109,115,G.R.P.
2008,6,16,24,213,856,1115,HAMIRPUR
2008,39,38,40,625,1825,2567,KANGRA
2008,1,8,4,46,224,283,KINNAUR
2008,18,32,38,224,954,1266,KULLU
2008,1,2,0,6,165,174,LAHAUL-SPITI
2008,26,64,28,294,1863,2275,MANDI
2008,25,44,40,593,1512,2214,SHIMLA
2008,9,20,28,223,750,1030,SIRMAUR
2008,19,28,30,354,1279,1710,SOLAN
2008,24,22,24,238,957,1265,UNA
2008,16,26,148,421,853,1464,ANANTNAG
2008,5,8,26,99,347,485,AWANTIPORA
2008,6,2,90,155,340,593,BANDIPORA
2008,53,26,126,422,847,1474,BARAMULLA
2008,30,16,132,460,1004,1642,BUDGAM
2008,2,0,0,2,104,108,CRIME JAMMU
2008,2,0,0,2,104,108,CRIME SRINAGAR
2008,61,40,48,106,498,753,DODA
2008,7,4,46,114,314,485,GANDERBAL
2008,28,12,34,71,260,405,HANDWARA
2008,118,52,102,1396,2814,4482,JAMMU
2008,0,2,2,12,190,206,KARGIL
2008,32,30,38,185,949,1234,KATHUA
2008,32,8,24,81,287,432,KISHTWAR
2008,15,10,90,179,420,714,KULGAM
2008,53,10,44,75,331,513,KUPWARA
2008,3,12,6,53,288,362,LEH
2008,40,32,50,124,677,923,POONCH
2008,21,4,60,158,352,595,PULWAMA
2008,1,0,2,22,104,129,RAILWAYS
2008,34,42,56,160,1136,1428,RAJOURI
2008,23,18,28,102,655,826,RAMBAN
2008,50,10,20,93,438,611,REASI
2008,32,4,18,113,647,814,SAMBA
2008,30,12,32,138,234,446,SHOPIAN
2008,93,32,158,923,1640,2846,SRINAGAR
2008,20,26,28,147,789,1010,UDHAMPUR
2008,84,80,82,1435,1726,3407,BOKARO
2008,173,84,14,306,459,1036,CHAIBASA
2008,88,22,34,253,851,1248,CHATRA
2008,50,66,22,459,1140,1737,DEOGHAR
2008,113,94,176,1857,2231,4471,DHANBAD
2008,13,0,2,256,174,445,DHANBAD RLY.
2008,94,120,52,505,1337,2108,DUMKA
2008,126,42,54,248,992,1462,GARHWA
2008,93,96,104,880,2145,3318,GIRIDIH
2008,105,52,82,396,1543,2178,GODDA
2008,237,76,74,298,511,1196,GUMLA
2008,132,114,130,1144,1992,3512,HAZARIBAGH
2008,190,82,72,1984,1776,4104,JAMSHEDPUR
2008,8,0,0,257,152,417,JAMSHEDPUR RLY.
2008,26,40,18,175,558,817,JAMTARA
2008,74,16,26,108,247,471,KHUNTI
2008,54,32,32,269,622,1009,KODERMA
2008,47,22,28,205,418,720,LATEHAR
2008,25,32,36,232,439,764,LOHARDAGGA
2008,121,106,36,204,560,1027,PAKUR
2008,276,60,114,517,1472,2439,PALAMU
2008,58,22,40,657,663,1440,RAMGARH
2008,281,124,234,3581,2256,6476,RANCHI
2008,89,122,70,306,556,1143,SAHEBGANJ
2008,115,26,28,455,518,1142,SARAIKELA
2008,86,52,24,153,249,564,SIMDEGA
2008,69,4,44,334,1737,2188,BAGALKOT
2008,550,108,318,22142,14142,37260,BANGALORE COMMR.
2008,156,28,44,1317,3402,4947,BANGALORE RURAL
2008,218,60,118,1572,5551,7519,BELGAUM
2008,93,22,38,720,2699,3572,BELLARY
2008,64,14,46,580,2841,3545,BIDAR
2008,156,38,46,478,2551,3269,BIJAPUR
2008,83,14,34,531,1465,2127,CBPURA
2008,56,8,14,346,1285,1709,CHAMARAJNAGAR
2008,70,34,46,584,2624,3358,CHICKMAGALUR
2008,57,36,40,717,3637,4487,CHITRADURGA
2008,74,20,20,742,3349,4205,DAKSHIN KANNADA
2008,44,20,70,695,2469,3298,DAVANAGERE
2008,47,6,30,1084,1518,2685,DHARWAD COMMR.
2008,47,2,12,131,1023,1215,DHARWAD RURAL
2008,45,20,20,240,992,1317,GADAG
2008,208,50,94,916,4664,5932,GULBARGA
2008,131,34,56,1025,4085,5331,HASSAN
2008,54,10,24,323,2037,2448,HAVERI
2008,23,10,10,199,747,989,K.G.F.
2008,55,40,12,331,1477,1915,KODAGU
2008,59,28,30,521,1657,2295,KOLAR
2008,26,12,24,301,1509,1872,KOPPAL
2008,91,36,28,964,4032,5151,MANDYA
2008,56,46,60,1553,2026,3741,MYSORE COMMR.
2008,105,26,28,698,2571,3428,MYSORE RURAL
2008,87,38,42,371,2575,3113,RAICHUR
2008,19,0,4,635,193,851,RAILWAYS
2008,152,34,38,1072,3231,4527,RAMANAGAR
2008,90,28,54,985,3933,5090,SHIMOGA
2008,124,24,36,1210,3837,5231,TUMKUR
2008,31,22,14,417,2060,2544,UDUPI
2008,33,20,22,297,2336,2708,UTTAR KANNADA
2008,45,32,40,1000,7238,8355,ALAPUZHA
2008,20,24,24,772,7260,8100,ERNAKULAM COMMR.
2008,67,70,26,1230,8046,9439,ERNAKULAM RURAL
2008,43,56,30,744,4207,5080,IDUKKI
2008,64,66,26,776,5033,5965,KANNUR
2008,42,56,30,544,2967,3639,KASARGOD
2008,47,122,46,1299,7379,8893,KOLLAM
2008,42,62,32,1160,6611,7907,KOTTAYAM
2008,22,30,24,930,3324,4330,KOZHIKODE COMMR.
2008,32,78,14,773,4637,5534,KOZHIKODE RURAL
2008,56,102,26,1507,5945,7636,MALAPPURAM
2008,53,84,30,789,4642,5598,PALAKKAD
2008,35,64,20,599,4679,5397,PATHANAMTHITTA
2008,1,2,0,305,143,451,RAILWAYS
2008,102,92,34,1210,8412,9850,THRISSUR
2008,32,40,36,1366,3666,5140,TRIVANDRUM COMMR.
2008,73,86,50,1303,6789,8301,TRIVANDRUM RURAL
2008,20,70,18,385,2089,2582,WAYANADU
2008,99,82,28,218,999,1426,ALIRAJPUR
2008,43,84,8,260,1012,1407,ANUPPUR
2008,38,94,6,406,1652,2196,ASHOK NAGAR
2008,77,122,16,520,2048,2783,BALAGHAT
2008,53,78,12,524,1512,2179,BARWANI
2008,90,242,52,680,2448,3512,BETUL
2008,128,54,26,701,2526,3435,BHIND
2008,146,226,84,6366,10349,17171,BHOPAL
2008,6,4,6,1892,455,2363,BHOPAL RLY.
2008,34,28,4,324,1165,1555,BURHANPUR
2008,114,114,52,1172,3760,5212,CHHATARPUR
2008,99,240,26,753,3770,4888,CHHINDWARA
2008,105,92,26,463,2385,3071,DAMOH
2008,95,50,34,480,1958,2617,DATIYA
2008,118,146,36,1503,4354,6157,DEWAS
2008,174,200,58,1280,4186,5898,DHAR
2008,22,40,2,82,704,850,DINDORI
2008,82,144,28,673,2452,3379,GUNA
2008,218,84,124,4902,5596,10924,GWALIOR
2008,44,36,18,353,960,1411,HARDA
2008,93,128,38,1069,2702,4030,HOSHANGABAD
2008,322,244,122,10916,12440,24044,INDORE
2008,5,6,0,387,227,625,INDORE RLY.
2008,180,254,104,2742,8520,11800,JABALPUR
2008,6,2,2,449,215,674,JABALPUR RLY.
2008,39,62,36,294,1295,1726,JHABUA
2008,59,96,14,565,2466,3200,KATNI
2008,71,104,24,890,2471,3560,KHANDWA
2008,94,130,16,1382,3109,4731,KHARGON
2008,50,94,6,201,1687,2038,MANDLA
2008,77,80,38,829,2657,3681,MANDSAUR
2008,134,52,70,1246,4115,5617,MORENA
2008,89,122,10,524,1959,2704,NARSINGHPUR
2008,38,38,24,695,1577,2372,NEEMUCH
2008,51,56,14,334,1390,1845,PANNA
2008,84,134,48,557,2798,3621,RAISEN
2008,101,166,56,785,3909,5017,RAJGARH
2008,87,126,32,724,2798,3767,RATLAM
2008,94,164,54,1778,3711,5801,REWA
2008,173,238,62,1592,6528,8593,SAGAR
2008,112,204,40,1647,4358,6361,SATNA
2008,64,122,32,335,2162,2715,SEONI
2008,43,94,26,657,2333,3153,SHAHDOL
2008,71,114,32,1148,2882,4247,SHAJAPUR
2008,28,26,20,167,1130,1371,SHEOPUR
2008,121,128,62,775,3316,4402,SHIVPURI
2008,42,74,34,533,1915,2598,SIDHI
2008,75,114,40,829,2738,3796,SIHORE
2008,43,80,26,481,1698,2328,SINGRAULI
2008,74,70,26,499,2547,3216,TIKAMGARH
2008,182,156,64,2884,6530,9816,UJJAIN
2008,32,50,12,266,1006,1366,UMARIYA
2008,85,186,28,1024,3358,4681,VIDISHA
2008,241,98,102,3679,4233,8353,AHMEDNAGAR
2008,126,52,70,2318,2494,5060,AKOLA
2008,48,44,20,1534,1444,3090,AMRAVATI COMMR.
2008,102,94,36,2288,2603,5123,AMRAVATI RURAL
2008,77,42,76,2279,1912,4386,AURANGABAD COMMR.
2008,92,42,22,1267,2414,3837,AURANGABAD RURAL
2008,95,52,78,1708,3157,5090,BEED
2008,42,52,28,1479,1814,3415,BHANDARA
2008,101,72,56,2036,2991,5256,BULDHANA
2008,98,74,68,2144,2964,5348,CHANDRAPUR
2008,92,20,16,1069,1975,3172,DHULE
2008,89,44,26,350,888,1397,GADCHIROLI
2008,49,76,28,908,1327,2388,GONDIA
2008,72,34,20,462,1366,1954,HINGOLI
2008,140,84,58,1835,3329,5446,JALGAON
2008,91,32,26,938,2044,3131,JALNA
2008,85,68,60,2257,2630,5100,KOLHAPUR
2008,102,44,58,1304,2667,4175,LATUR
2008,342,436,378,29180,12975,43311,MUMBAI COMMR.
2008,9,8,16,3918,277,4228,MUMBAI RLY.
2008,157,106,86,5441,4625,10415,NAGPUR COMMR.
2008,12,2,6,2049,279,2348,NAGPUR RLY.
2008,122,74,48,2067,3115,5426,NAGPUR RURAL
2008,145,46,58,1397,3549,5195,NANDED
2008,44,22,20,522,1174,1782,NANDURBAR
2008,74,28,68,3331,1581,5082,NASIK COMMR.
2008,145,72,66,1366,3332,4981,NASIK RURAL
2008,100,24,52,4032,2054,6262,NAVI MUMBAI
2008,78,44,44,1029,2180,3375,OSMANABAD
2008,86,24,34,1033,1949,3126,PARBHANI
2008,278,184,220,12868,5932,19482,PUNE COMMR.
2008,4,2,2,771,152,931,PUNE RLY.
2008,223,132,92,3526,4446,8419,PUNE RURAL
2008,74,34,12,783,1483,2386,RAIGAD
2008,33,52,30,605,1100,1820,RATNAGIRI
2008,73,84,42,1482,1752,3433,SANGLI
2008,87,60,42,2704,2727,5620,SATARA
2008,13,16,4,329,599,961,SINDHUDURG
2008,32,48,24,1085,973,2162,SOLAPUR COMMR.
2008,147,126,96,1770,3257,5396,SOLAPUR RURAL
2008,175,148,206,6409,4472,11410,THANE COMMR.
2008,186,142,100,2915,3439,6782,THANE RURAL
2008,63,52,52,1989,2994,5150,WARDHA
2008,59,40,44,1102,1482,2727,WASHIM
2008,129,86,68,2282,3318,5883,YAVATMAL
2008,59,6,28,102,259,454,BISHNUPUR
2008,23,0,4,10,145,182,CHANDEL
2008,23,4,10,39,173,249,CHURACHANDPUR
2008,0,0,0,0,104,104,CID
2008,133,18,86,250,413,900,IMPHAL EAST
2008,234,24,120,520,609,1507,IMPHAL WEST
2008,20,4,12,65,173,274,SENAPATI
2008,6,0,4,10,117,137,TAMENGLONG
2008,172,18,88,171,366,815,THOUBAL
2008,15,2,0,21,143,181,UKHRUL
2008,15,2,20,75,155,267,GARO HILLS EAST
2008,5,4,4,31,112,156,GARO HILLS SOUTH
2008,36,20,18,338,348,760,GARO HILLS WEST
2008,43,36,14,211,224,528,JAINTIA HILLS
2008,46,68,38,748,357,1257,KHASI HILLS EAST
2008,20,32,10,80,153,295,KHASI HILLS WEST
2008,16,14,8,151,211,400,RI-BHOI
2008,19,78,2,946,369,1414,AIZAWL
2008,5,14,2,171,131,323,CHAMPHAI
2008,3,18,8,206,167,402,KOLASIB
2008,4,16,0,82,181,283,LAWNGTLAI
2008,8,16,4,255,172,455,LUNGLEI
2008,1,4,2,52,121,180,MAMIT
2008,2,0,0,49,147,198,SAIHA
2008,3,8,0,81,132,224,SERCHHIP
2008,77,12,62,498,193,842,DIMAPUR
2008,4,0,0,12,115,131,KIPHIRE
2008,34,12,10,121,150,327,KOHIMA
2008,2,0,0,3,107,112,LONGLENG
2008,18,2,6,46,124,196,MOKOKCHUNG
2008,17,2,0,52,136,207,MON
2008,6,2,0,12,107,127,PEREN
2008,17,4,2,19,125,167,PHEK
2008,3,2,0,11,127,143,TUENSANG
2008,10,0,8,86,137,241,WOKHA
2008,2,2,0,50,132,186,ZUNHEBOTO
2008,117,94,98,972,1623,2904,ANGUL
2008,75,100,94,896,1983,3148,BALASORE
2008,112,58,16,412,1099,1697,BARAGARH
2008,63,46,44,372,677,1202,BERHAMPUR
2008,54,116,92,313,1676,2251,BHADRAK
2008,71,68,48,460,1319,1966,BOLANGIR
2008,18,10,4,65,430,527,BOUDH
2008,64,70,70,566,1837,2607,CUTTACK
2008,109,72,90,2896,1971,5138,DCP BBSR
2008,35,36,42,1389,1007,2509,DCP CTC
2008,63,26,16,109,527,741,DEOGARH
2008,104,52,48,448,1255,1907,DHENKANAL
2008,29,16,8,60,437,550,GAJAPATI
2008,210,96,90,529,1226,2151,GANJAM
2008,33,50,58,420,1062,1623,JAGATSINGHPUR
2008,140,72,128,635,1533,2508,JAJPUR
2008,56,24,24,737,1005,1846,JHARSUGUDA
2008,39,76,58,232,1068,1473,KALAHANDI
2008,57,92,30,170,1335,1684,KANDHAMAL
2008,61,60,62,338,1116,1637,KENDRAPARA
2008,243,132,116,739,1312,2542,KEONJHAR
2008,30,50,66,396,1104,1646,KHURDA
2008,103,94,56,390,994,1637,KORAPUT
2008,80,24,16,113,280,513,MALKANGIR
2008,148,180,102,643,1612,2685,MAYURBHANJ
2008,41,68,50,297,888,1344,NAYAGARH
2008,55,52,42,218,618,985,NOWRANGPUR
2008,19,28,34,191,579,851,NUAPADA
2008,58,74,62,1105,2121,3420,PURI
2008,34,38,28,202,537,839,RAYAGADA
2008,93,76,46,827,1520,2562,ROURKELA
2008,104,66,26,924,1605,2725,SAMBALPUR
2008,35,30,6,179,365,615,SONEPUR
2008,5,2,8,664,243,922,SRP(CUTTACK)
2008,10,2,4,294,231,541,SRP(ROURKELA)
2008,97,76,34,454,930,1591,SUNDARGARH
2008,117,30,108,1121,1215,2591,AMRITSAR
2008,68,20,46,183,476,793,AMRITSAR RURAL
2008,57,24,14,169,555,819,BARNALA
2008,25,40,38,256,551,910,BATALA
2008,107,40,88,1137,1252,2624,BHATINDA
2008,37,30,26,349,637,1079,FARIDKOT
2008,28,26,32,388,708,1182,FATEHGARH SAHIB
2008,124,60,60,777,1239,2260,FEROZPUR
2008,13,2,0,92,425,532,G.R.P
2008,41,48,50,329,655,1123,GURDASPUR
2008,82,70,44,462,1057,1715,HOSHIARPUR
2008,177,102,220,1825,2094,4418,JALANDHAR
2008,93,48,46,740,794,1721,KAPURTHALA
2008,37,24,38,447,749,1295,KHANNA
2008,142,92,230,1414,1765,3643,LUDHIANA
2008,36,28,42,299,580,985,LUDHIANA RURAL
2008,73,26,22,224,623,968,MANSA
2008,56,38,48,357,739,1238,MOGA
2008,67,24,24,307,548,970,MUKTSAR
2008,91,70,88,966,1725,2940,PATIALA
2008,23,20,22,303,643,1011,ROPAR
2008,95,68,46,626,1255,2090,SANGRUR
2008,36,40,56,889,965,1986,SAS NGR
2008,32,28,14,206,587,867,SBS NAGAR
2008,68,36,34,210,642,990,TARN TARAN
2008,83,90,204,1691,4452,6520,AJMER
2008,160,176,284,2828,5674,9122,ALWAR
2008,51,84,100,280,1960,2475,BANSWARA
2008,146,104,90,692,2129,3161,BARAN
2008,41,40,48,467,2285,2881,BARMER
2008,116,148,200,1875,5441,7780,BHARATPUR
2008,72,84,136,1680,3260,5232,BHILWARA
2008,108,96,58,865,2997,4124,BIKANER
2008,84,66,140,574,2432,3296,BUNDI
2008,56,80,208,1194,3415,4953,CHITTORGARH
2008,55,74,86,508,2139,2862,CHURU
2008,65,42,122,1773,3296,5298,DAUSA
2008,128,42,128,927,2861,4086,DHOLPUR
2008,38,52,100,219,1757,2166,DUNGARPUR
2008,8,4,8,745,430,1195,G.R.P.
2008,110,140,132,884,3303,4569,GANGANAGAR
2008,137,66,70,498,2473,3244,HANUMANGARH
2008,42,40,128,5468,2835,8513,JAIPUR EAST
2008,51,50,138,1640,2048,3927,JAIPUR NORTH
2008,98,70,220,2540,6556,9484,JAIPUR RURAL
2008,42,30,104,3409,2414,5999,JAIPUR SOUTH
2008,7,8,22,279,814,1130,JAISALMER
2008,43,26,54,370,2073,2566,JALORE
2008,157,88,132,931,2380,3688,JHALAWAR
2008,54,80,88,922,2911,4055,JHUNJHUNU
2008,69,38,86,1693,1744,3630,JODHPUR CITY
2008,48,64,62,613,2463,3250,JODHPUR RURAL
2008,73,66,128,1180,2888,4335,KARAULI
2008,168,48,132,2140,2128,4616,KOTA CITY
2008,74,68,60,464,1405,2071,KOTA RURAL
2008,78,66,128,906,2700,3878,NAGAUR
2008,57,86,192,848,3661,4844,PALI
2008,44,98,108,300,1510,2060,PRATAPGARH
2008,24,24,96,422,1778,2344,RAJSAMAND
2008,56,32,100,1038,2601,3827,SAWAI MADHOPUR
2008,71,80,96,1000,3130,4377,SIKAR
2008,47,34,80,373,1374,1908,SIROHI
2008,43,44,100,740,2530,3457,TONK
2008,142,182,348,1552,4799,7023,UDAIPUR
2008,10,10,4,180,276,480,EAST
2008,3,2,0,16,129,150,NORTH
2008,1,18,2,87,214,322,SOUTH
2008,2,10,2,60,197,271,WEST
2008,230,70,86,3458,9368,13212,CHENNAI
2008,5,0,2,518,363,888,CHENNAI RLY.
2008,150,42,58,1370,2439,4059,CHENNAISUBURBAN
2008,165,28,126,2898,9005,12222,COIMBATORE RURAL
2008,48,18,34,1332,3366,4798,COIMBATORE URBAN
2008,134,32,112,1020,5798,7096,CUDDALORE
2008,106,24,98,508,4157,4893,DHARMAPURI
2008,127,26,106,897,3889,5045,DINDIGUL
2008,103,42,114,1534,6918,8711,ERODE
2008,151,48,36,858,6298,7391,KANCHIPURAM
2008,87,16,84,978,3921,5086,KANYAKUMARI
2008,37,8,26,694,2118,2883,KARUR
2008,119,40,88,766,4448,5461,KRISHNAGIRI
2008,134,36,64,657,4165,5056,MADURAI RURAL
2008,77,8,48,1138,1732,3003,MADURAI URBAN
2008,111,20,56,517,3724,4428,NAGAPATTINAM
2008,80,38,98,717,4038,4971,NAMAKKAL
2008,16,8,8,298,1223,1553,NILGIRIS
2008,79,52,62,698,2623,3514,PERAMBALUR
2008,79,8,68,414,2693,3262,PUDUKOTTAI
2008,140,12,56,552,2429,3189,RAMNATHAPURAM
2008,172,70,224,821,6433,7720,SALEM RURAL
2008,69,44,64,590,1868,2635,SALEM URBAN
2008,81,2,86,651,2371,3191,SIVAGANGAI
2008,159,14,58,1265,6459,7955,THANJAVUR
2008,83,14,70,622,4491,5280,THENI
2008,337,84,136,1159,6564,8280,THIRUNELVELI RURAL
2008,65,16,32,535,1259,1907,THIRUNELVELI URBAN
2008,76,34,44,578,3700,4432,THIRUVALLUR
2008,97,40,68,682,4112,4999,THIRUVANNAMALAI
2008,62,12,28,312,2523,2937,THIRUVARUR
2008,199,22,96,1341,4434,6092,THOOTHUGUDI
2008,2,0,0,77,159,238,TRICHY RLY.
2008,82,22,56,581,3229,3970,TRICHY RURAL
2008,43,4,20,955,2748,3770,TRICHY URBAN
2008,107,42,106,993,6309,7557,VELLORE
2008,160,116,128,747,5897,7048,VILLUPURAM
2008,114,34,104,984,3471,4707,VIRUDHUNAGAR
2008,23,64,36,119,341,583,DHALAI
2008,44,92,54,224,758,1172,NORTH
2008,55,90,68,393,1054,1660,SOUTH
2008,86,162,134,591,1731,2704,WEST
2008,242,84,458,3940,3747,8471,AGRA
2008,282,124,324,1628,2328,4686,ALIGARH
2008,232,98,288,1839,3301,5758,ALLAHABAD
2008,52,36,102,303,721,1214,AMBEDKAR NAGAR
2008,46,22,58,208,673,1007,AURAIYA
2008,111,48,120,453,1252,1984,AZAMGARH
2008,177,22,106,293,1627,2225,BADAUN
2008,136,38,102,436,1048,1760,BAGHPAT
2008,85,48,128,347,834,1442,BAHRAICH
2008,71,24,66,376,588,1125,BALLIA
2008,26,24,42,113,290,495,BALRAMPUR
2008,58,70,80,357,1320,1885,BANDA
2008,124,46,166,520,2352,3208,BARABANKI
2008,292,92,310,1454,3502,5650,BAREILLY
2008,48,14,36,202,751,1051,BASTI
2008,161,60,184,529,1495,2429,BIJNOR
2008,202,56,154,505,2759,3676,BULANDSHAHAR
2008,51,8,22,293,870,1244,CHANDOLI
2008,42,44,40,154,375,655,CHITRAKOOT DHAM
2008,49,30,40,202,648,969,DEORIA
2008,146,40,160,577,1323,2246,ETAH
2008,142,38,178,793,1598,2749,ETAWAH
2008,57,46,116,500,1198,1917,FAIZABAD
2008,125,46,122,351,1008,1652,FATEHGARH
2008,109,32,106,376,1287,1910,FATEHPUR
2008,260,54,228,1006,1883,3431,FIROZABAD
2008,30,4,22,3111,1021,4188,G.R.P.
2008,128,44,140,3532,1289,5133,GAUTAMBUDH NAGAR
2008,281,60,398,2470,2655,5864,GHAZIABAD
2008,77,12,50,348,709,1196,GHAZIPUR
2008,102,54,108,370,879,1513,GONDA
2008,114,92,300,1164,1671,3341,GORAKHPUR
2008,31,18,42,59,380,530,HAMIRPUR
2008,124,84,128,411,1590,2337,HARDOI
2008,98,34,124,468,911,1635,HATHRAS
2008,72,40,76,310,753,1251,J.P.NAGAR
2008,55,12,68,196,887,1218,JALAUN
2008,91,38,94,481,1613,2317,JAUNPUR
2008,54,14,50,319,706,1143,JHANSI
2008,74,22,84,181,897,1258,KANNAUJ
2008,85,52,134,335,1614,2220,KANPUR DEHAT
2008,282,144,592,3037,5447,9502,KANPUR NAGAR
2008,114,38,80,192,648,1072,KANSHIRAM NAGAR
2008,87,52,92,334,1212,1777,KAUSHAMBI
2008,156,116,190,706,1909,3077,KHIRI
2008,32,12,30,85,890,1049,KUSHI NAGAR
2008,26,32,24,139,405,626,LALITPUR
2008,290,164,778,7169,6994,15395,LUCKNOW
2008,28,34,52,107,689,910,MAHARAJGANJ
2008,34,24,52,163,499,772,MAHOBA
2008,198,18,176,589,1435,2416,MAINPURI
2008,218,48,152,1427,2493,4338,MATHURA
2008,65,38,100,325,729,1257,MAU
2008,326,100,356,2169,2853,5804,MEERUT
2008,66,38,46,420,887,1457,MIRZAPUR
2008,244,150,358,1801,3199,5752,MORADABAD
2008,343,80,270,1407,2318,4418,MUZAFFARNAGAR
2008,107,82,216,389,1786,2580,PILIBHIT
2008,112,66,184,591,1704,2657,PRATAPGARH
2008,110,76,120,434,1603,2343,RAIBAREILLY
2008,150,92,214,795,1288,2539,RAMPUR
2008,129,16,62,843,1902,2952,SAHARANPUR
2008,29,18,80,167,662,956,SANT KABIRNAGAR
2008,257,136,242,535,1695,2865,SHAHJAHANPUR
2008,33,12,32,119,315,511,SHRAWASTI
2008,30,24,64,250,569,937,SIDHARTHNAGAR
2008,151,106,276,911,2302,3746,SITAPUR
2008,49,52,60,255,680,1096,SONBHADRA
2008,39,4,22,157,366,588,ST.RAVIDASNAGAR
2008,136,50,108,554,1327,2175,SULTANPUR
2008,119,72,156,423,1015,1785,UNNAO
2008,95,24,118,1793,2293,4323,VARANASI
2008,19,4,14,84,256,377,ALMORA
2008,6,4,6,25,136,177,BAGESHWAR
2008,3,4,12,46,151,216,CHAMOLI
2008,4,4,8,31,151,198,CHAMPAWAT
2008,93,40,130,1288,1429,2980,DEHRADUN
2008,136,48,122,1124,1524,2954,HARIDWAR
2008,48,18,44,366,647,1123,NAINITAL
2008,9,0,8,66,197,280,PAURI GARHWAL
2008,9,0,0,41,208,258,PITHORAGARH
2008,0,0,0,25,127,152,RUDRA PRAYAG
2008,11,6,6,78,258,359,TEHRI GARHWAL
2008,95,44,134,607,1169,2049,UDHAMSINGH NAGAR
2008,7,2,10,48,180,247,UTTARKASHI
2008,360,384,634,3310,7945,12633,24 PARGANAS NORTH
2008,274,616,560,3844,10608,15902,24 PARGANAS SOUTH
2008,53,40,36,481,1348,1958,ASANSOL
2008,91,92,42,425,1070,1720,BANKURA
2008,120,116,92,780,1832,2940,BIRBHUM
2008,160,122,174,1143,3008,4607,BURDWAN
2008,108,282,216,409,1837,2852,COOCHBEHAR
2008,142,94,100,280,1151,1767,DAKSHIN DINAJPUR
2008,49,94,92,1133,1472,2840,DARJEELING
2008,176,108,100,1431,2803,4618,HOOGHLY
2008,93,92,210,1829,4019,6243,HOWRAH
2008,47,0,6,1053,173,1279,HOWRAH G.R.P.
2008,260,668,598,5980,8446,15952,JALPAIGURI
2008,7,0,0,213,123,343,KHARAGPUR G.R.P.
2008,128,70,232,7013,7425,14868,KOLKATA
2008,207,260,184,663,1954,3268,MALDA
2008,371,616,388,1168,4542,7085,MURSHIDABAD
2008,447,356,432,2573,4649,8457,NADIA
2008,138,112,114,665,2234,3263,PASCHIM MIDNAPUR
2008,89,120,236,836,3142,4423,PURAB MIDNAPUR
2008,44,122,46,568,1312,2092,PURULIA
2008,12,4,12,307,171,506,SEALDAH G.R.P.
2008,2,2,12,195,126,337,SILIGURI G.R.P.
2008,165,156,148,683,2036,3188,UTTAR DINAJPUR
2008,18,24,32,336,649,1059,ANDAMAN
2008,1,0,2,12,116,131,NICOBAR
2008,45,40,100,4267,1369,5821,CHANDIGARH
2008,11,12,34,158,329,544,D and N HAVELI
2008,3,0,4,123,202,332,DAMAN
2008,1,0,4,26,138,169,DIU
2008,0,0,0,0,210,210,CAW
2008,67,60,168,2915,1282,4492,CENTRAL
2008,2,0,0,2,117,121,CRIME BRANCH
2008,100,146,382,5214,2272,8114,EAST
2008,0,0,0,0,129,129,EOW
2008,6,0,12,1648,202,1868,GRP(RLY)
2008,2,0,2,163,532,699,IGI AIRPORT
2008,12,6,38,1452,996,2504,NEW DELHI
2008,43,40,160,2000,1787,4030,NORTH
2008,142,64,420,3270,2291,6187,NORTH-EAST
2008,102,118,274,3869,1757,6120,NORTH-WEST
2008,130,118,710,4048,2408,7414,OUTER
2008,55,74,140,4244,2225,6738,SOUTH
2008,103,122,364,4651,2896,8136,SOUTH-EAST
2008,93,76,174,2421,2397,5161,SOUTH-WEST
2008,10,0,0,1,122,133,STF
2008,76,108,290,4461,2502,7437,WEST
2008,1,4,2,19,184,210,LAKSHADWEEP
2008,11,2,4,156,702,875,KARAIKAL
2008,59,14,30,1333,3465,4901,PUDUCHERRY
2009,124,134,146,928,4200,5532,ADILABAD
2009,218,44,136,1303,3932,5633,ANANTAPUR
2009,153,66,148,2688,5209,8264,CHITTOOR
2009,137,54,114,1034,4418,5757,CUDDAPAH
2009,270,164,336,8148,8149,17067,CYBERABAD
2009,189,94,160,2726,6239,9408,EAST GODAVARI
2009,7,0,0,338,136,481,GUNTAKAL RLY.
2009,290,80,158,2765,7170,10463,GUNTUR
2009,263,94,216,11215,9010,20798,HYDERABAD CITY
2009,189,96,256,1343,6098,7982,KARIMNAGAR
2009,187,196,216,1309,4739,6647,KHAMMAM
2009,176,86,98,1220,4567,6147,KRISHNA
2009,273,62,166,1300,6221,8022,KURNOOL
2009,226,148,206,2291,4969,7840,MAHABOOBNAGAR
2009,181,92,122,1485,4403,6283,MEDAK
2009,187,154,218,1301,6962,8822,NALGONDA
2009,148,64,100,1408,4405,6125,NELLORE
2009,161,54,92,1095,3781,5183,NIZAMABAD
2009,169,54,132,1030,4932,6317,PRAKASHAM
2009,90,52,58,362,1659,2221,RANGA REDDY
2009,10,0,0,926,213,1149,SECUNDERABAD RLY.
2009,33,42,40,455,2938,3508,SRIKAKULAM
2009,88,46,126,2472,3268,6000,VIJAYAWADA CITY
2009,7,0,0,1024,166,1197,VIJAYAWADA RLY.
2009,83,28,36,414,2328,2889,VISAKHA RURAL
2009,53,78,96,2413,3576,6216,VISAKHAPATNAM
2009,54,26,30,617,2863,3590,VIZIANAGARAM
2009,145,140,280,1326,5805,7696,WARANGAL
2009,197,228,230,2893,5797,9345,WEST GODAVARI
2009,0,0,0,2,122,124,ANJAW
2009,5,16,14,116,203,354,CHANGLANG
2009,2,6,12,57,169,246,DIBANG VALLEY
2009,10,10,0,21,142,183,K/KUMEY
2009,5,6,10,54,213,288,KAMENG EAST
2009,8,2,0,32,203,245,KAMENG WEST
2009,10,16,12,89,188,315,LOHIT
2009,11,22,26,224,368,651,PAPUM PARE
2009,5,18,20,140,206,389,SIANG EAST
2009,0,4,2,29,132,167,SIANG UPPER
2009,14,10,10,75,258,367,SIANG WEST
2009,4,4,8,44,177,237,SUBANSIRI LOWER
2009,7,2,2,40,200,251,SUBANSIRI UPPER
2009,1,0,0,33,126,160,TAWANG
2009,8,2,8,73,199,290,TIRAP
2009,2,0,0,9,120,131,UPPER DIBANG VALLEY
2009,66,246,226,579,1719,2836,BARPETA
2009,43,36,76,83,339,577,BASKA
2009,22,108,116,396,914,1556,BONGAIGAON
2009,1,0,0,2,112,115,C.I.D.
2009,66,140,304,1368,3393,5271,CACHAR
2009,35,70,116,157,456,834,CHIRANG
2009,37,160,198,587,1595,2577,DARRANG
2009,47,124,142,302,686,1301,DHEMAJI
2009,69,300,370,670,2272,3681,DHUBRI
2009,81,92,220,1119,1297,2809,DIBRUGARH
2009,8,0,4,313,228,553,G.R.P.
2009,55,180,178,427,1331,2171,GOALPARA
2009,77,70,202,578,1022,1949,GOLAGHAT
2009,120,108,586,4284,3820,8918,GUWAHATI CITY
2009,13,90,118,234,977,1432,HAILAKANDI
2009,30,72,108,622,877,1709,JORHAT
2009,63,114,242,620,1735,2774,KAMRUP
2009,53,34,42,266,451,846,KARBI ANGLONG
2009,44,52,78,231,950,1355,KARIMGANJ
2009,94,88,142,347,831,1502,KOKRAJHAR
2009,51,108,246,510,1373,2288,LAKHIMPUR
2009,36,176,154,236,974,1576,MORIGAON
2009,85,6,32,45,210,378,N.C.HILLS
2009,142,324,466,1253,3589,5774,NAGAON
2009,45,62,116,424,946,1593,NALBARI
2009,4,14,2,21,167,208,R.P.O.
2009,92,142,240,1049,1247,2770,SIBSAGAR
2009,129,178,348,904,1919,3478,SONITPUR
2009,85,116,212,1457,1330,3200,TINSUKIA
2009,47,52,152,305,561,1117,UDALGURI
2009,71,56,112,630,1630,2499,ARARIA
2009,38,4,32,127,606,807,ARWAL
2009,73,38,108,864,2457,3540,AURANGABAD
2009,79,16,92,327,1182,1696,BAGAHA
2009,131,62,108,425,1362,2088,BANKA
2009,346,24,158,748,2429,3705,BEGUSARAI
2009,81,44,164,661,2634,3584,BETTIAH
2009,83,8,76,496,1422,2085,BHABHUA
2009,81,56,114,1190,2407,3848,BHAGALPUR
2009,128,22,100,1046,2971,4267,BHOJPUR
2009,90,28,128,542,1397,2185,BUXAR
2009,170,54,166,753,3388,4531,DARBHANGA
2009,188,40,216,1636,3257,5337,GAYA
2009,208,74,224,553,1908,2967,GOPALGANJ
2009,8,2,6,270,172,458,JAMALPUR RLY.
2009,221,30,70,395,1760,2476,JAMUI
2009,58,16,80,318,1342,1814,JEHANABAD
2009,108,240,260,456,1940,3004,KATIHAR
2009,9,2,4,393,242,650,KATIHAR RLY.
2009,160,16,98,327,1283,1884,KHAGARIA
2009,32,66,82,409,978,1567,KISHANGANJ
2009,118,30,78,265,977,1468,LAKHISARAI
2009,55,22,100,481,1435,2093,MADHEPURA
2009,73,38,162,905,3524,4702,MADHUBANI
2009,380,62,312,1233,3808,5795,MOTIHARI
2009,212,24,136,665,1338,2375,MUNGER
2009,169,110,302,1892,3943,6416,MUZAFFARPUR
2009,40,6,10,687,278,1021,MUZAFFARPUR RLY.
2009,415,66,198,1029,3476,5184,NALANDA
2009,95,12,72,165,1303,1647,NAUGACHIA
2009,87,28,128,352,1810,2405,NAWADAH
2009,418,92,702,6585,9434,17231,PATNA
2009,27,0,34,1370,454,1885,PATNA RLY.
2009,205,98,138,508,2069,3018,PURNEA
2009,173,36,166,1361,2983,4719,ROHTAS
2009,172,56,110,473,1496,2307,SAHARSA
2009,320,52,260,955,3072,4659,SAMASTIPUR
2009,287,22,182,1409,2575,4475,SARAN
2009,16,12,20,215,872,1135,SHEIKHPURA
2009,37,8,50,132,492,719,SHEOHAR
2009,89,16,208,964,3032,4309,SITAMARHI
2009,132,28,178,631,1696,2665,SIWAN
2009,174,52,84,300,1242,1852,SUPAUL
2009,163,90,416,1202,3074,4945,VAISHALI
2009,59,86,20,169,587,921,BALRAMPUR
2009,148,118,90,2349,4542,7247,BILASPUR
2009,163,20,8,27,203,421,BIZAPUR
2009,136,28,20,188,527,899,DANTEWARA
2009,31,48,14,403,1123,1619,DHAMTARI
2009,132,218,38,2090,5475,7953,DURG
2009,9,0,2,553,168,732,GRP RAIPUR
2009,116,120,38,520,1718,2512,JAGDALPUR
2009,81,50,26,765,2295,3217,JANJGIR
2009,76,128,52,359,871,1486,JASHPUR
2009,34,40,4,281,1356,1715,KABIRDHAM
2009,72,44,22,157,830,1125,KANKER
2009,70,70,12,687,1825,2664,KORBA
2009,44,140,16,428,1148,1776,KORIYA
2009,28,56,12,491,1294,1881,MAHASAMUND
2009,68,2,0,16,189,275,NARAYANPUR
2009,106,86,36,1090,1994,3312,RAIGARH
2009,195,290,84,4174,6574,11317,RAIPUR
2009,86,94,26,750,2430,3386,RAJNANDGAON
2009,86,162,30,415,1351,2044,SARGUJA
2009,75,152,22,351,1041,1641,SURAJPUR
2009,42,62,34,1066,933,2137,NORTH GOA
2009,35,32,32,978,705,1782,SOUTH GOA
2009,133,126,362,14179,12047,26847,AHMEDABAD COMMR.
2009,38,18,100,940,2581,3677,AHMEDABAD RURAL
2009,6,6,0,9,237,258,AHWA-DANG
2009,35,16,104,570,1803,2528,AMRELI
2009,40,26,86,945,2839,3936,ANAND
2009,45,36,56,1010,2504,3651,BHARUCH
2009,65,18,142,1636,3483,5344,BHAVNAGAR
2009,69,20,80,513,1082,1764,DAHOD
2009,36,14,60,1345,4082,5537,GANDHINAGAR
2009,49,30,72,508,2940,3599,HIMATNAGAR
2009,51,34,48,884,4115,5132,JAMNAGAR
2009,76,28,138,1637,4371,6250,JUNAGADH
2009,35,30,68,706,3690,4529,KHEDA NORTH
2009,55,20,78,1025,3278,4456,KUTCH
2009,50,20,110,1383,3781,5344,MEHSANA
2009,16,12,6,83,765,882,NARMADA
2009,23,8,2,195,797,1025,NAVSARI
2009,54,52,178,1190,3408,4882,PALANPUR
2009,51,30,104,705,2933,3823,PANCHMAHAL
2009,32,38,42,768,2085,2965,PATAN
2009,18,6,36,200,887,1147,PORBANDAR
2009,61,16,94,2591,2914,5676,RAJKOT COMMR.
2009,69,56,114,930,3557,4726,RAJKOT RURAL
2009,116,56,238,4982,4406,9798,SURAT COMMR.
2009,44,20,24,266,1292,1646,SURAT RURAL
2009,50,36,116,524,2500,3226,SURENDRANAGAR
2009,15,14,8,132,653,822,TAPI
2009,49,12,66,3154,3207,6488,VADODARA COMMR.
2009,66,46,138,615,2343,3208,VADODARA RURAL
2009,24,20,24,660,1378,2106,VALSAD
2009,17,2,2,1218,319,1558,W.RLY
2009,53,56,40,1114,1508,2771,AMBALA
2009,88,74,148,1124,1824,3258,BHIWANI
2009,107,70,172,2600,2611,5560,FARIDABAD
2009,47,18,94,661,1187,2007,FATEHABAD
2009,32,6,6,959,823,1826,GRP
2009,122,58,118,5682,2665,8645,GURGAON
2009,116,66,84,1489,2202,3957,HISSAR
2009,102,40,54,895,1128,2219,JHAJJAR
2009,86,70,92,1182,1410,2840,JIND
2009,40,48,38,730,1201,2057,KAITHAL
2009,73,96,102,1629,2131,4031,KARNAL
2009,49,86,114,1446,1449,3144,KURUKSHETRA
2009,35,20,42,474,1387,1958,MAHENDRAGARH
2009,41,32,48,611,1185,1917,MEWAT
2009,77,66,70,1228,1521,2962,PALWAL
2009,20,36,34,981,899,1970,PANCHKULA
2009,94,90,102,1752,1628,3666,PANIPAT
2009,57,38,72,927,1486,2580,REWARI
2009,126,72,86,1664,1594,3542,ROHTAK
2009,54,48,86,788,1182,2158,SIRSA
2009,153,64,114,1901,2013,4245,SONIPAT
2009,66,52,116,1203,1441,2878,YAMUNANAGAR
2009,11,4,6,85,439,545,BADDIPOLICEDIST
2009,14,28,12,133,989,1176,BILASPUR
2009,11,40,32,142,611,836,CHAMBA
2009,0,0,0,0,105,105,CID
2009,2,0,0,4,108,114,G.R.P.
2009,10,18,32,120,870,1050,HAMIRPUR
2009,46,46,48,425,2087,2652,KANGRA
2009,3,12,4,24,270,313,KINNAUR
2009,13,48,24,168,860,1113,KULLU
2009,1,2,0,8,162,173,LAHAUL-SPITI
2009,16,44,28,200,1748,2036,MANDI
2009,30,56,56,512,1374,2028,SHIMLA
2009,12,30,20,198,766,1026,SIRMAUR
2009,11,16,18,235,743,1023,SOLAN
2009,18,22,20,201,868,1129,UNA
2009,25,16,162,503,937,1643,ANANTNAG
2009,8,10,22,121,454,615,AWANTIPORA
2009,8,8,108,149,332,605,BANDIPORA
2009,74,28,172,620,948,1842,BARAMULLA
2009,31,20,152,626,858,1687,BUDGAM
2009,1,0,0,2,104,107,CRIME JAMMU
2009,0,0,0,0,105,105,CRIME SRINAGAR
2009,61,36,78,112,592,879,DODA
2009,5,14,52,143,364,578,GANDERBAL
2009,28,10,34,91,314,477,HANDWARA
2009,95,58,138,1492,2609,4392,JAMMU
2009,0,2,2,19,190,213,KARGIL
2009,29,18,50,149,913,1159,KATHUA
2009,36,6,46,71,256,415,KISHTWAR
2009,18,18,104,203,512,855,KULGAM
2009,47,12,48,120,328,555,KUPWARA
2009,5,4,2,35,232,278,LEH
2009,50,24,42,109,669,894,POONCH
2009,10,10,64,196,346,626,PULWAMA
2009,2,0,0,28,114,144,RAILWAYS
2009,0,0,0,1,111,112,RAILWAYS KMR
2009,30,44,70,146,1064,1354,RAJOURI
2009,17,24,30,58,675,804,RAMBAN
2009,40,18,28,120,472,678,REASI
2009,15,12,16,126,666,835,SAMBA
2009,30,10,82,212,324,658,SHOPIAN
2009,93,42,226,1315,1777,3453,SRINAGAR
2009,26,30,18,131,858,1063,UDHAMPUR
2009,75,36,74,1275,1603,3063,BOKARO
2009,160,68,26,327,469,1050,CHAIBASA
2009,78,32,42,196,706,1054,CHATRA
2009,108,90,58,713,1003,1972,DEOGHAR
2009,102,72,162,2492,2114,4942,DHANBAD
2009,7,0,6,345,211,569,DHANBAD RLY.
2009,76,122,68,455,1123,1844,DUMKA
2009,79,54,74,248,1044,1499,GARHWA
2009,118,56,72,718,1952,2916,GIRIDIH
2009,107,48,72,378,905,1510,GODDA
2009,205,78,72,275,533,1163,GUMLA
2009,154,66,106,967,1652,2945,HAZARIBAGH
2009,322,92,128,2890,1481,4913,JAMSHEDPUR
2009,7,2,6,344,174,533,JAMSHEDPUR RLY.
2009,48,42,24,152,340,606,JAMTARA
2009,78,8,30,105,276,497,KHUNTI
2009,32,12,28,302,768,1142,KODERMA
2009,62,26,44,169,533,834,LATEHAR
2009,40,40,20,174,366,640,LOHARDAGGA
2009,78,92,36,137,545,888,PAKUR
2009,228,74,122,487,1260,2171,PALAMU
2009,32,32,38,568,684,1354,RAMGARH
2009,413,126,226,3582,2410,6757,RANCHI
2009,125,90,70,236,627,1148,SAHEBGANJ
2009,97,46,30,471,535,1179,SARAIKELA
2009,79,34,20,63,248,444,SIMDEGA
2009,76,16,36,371,1769,2268,BAGALKOT
2009,594,130,540,26114,13698,41076,BANGALORE COMMR.
2009,167,28,46,1832,2936,5009,BANGALORE RURAL
2009,198,78,120,1510,5657,7563,BELGAUM
2009,90,22,50,835,2539,3536,BELLARY
2009,63,24,28,473,3205,3793,BIDAR
2009,128,38,56,482,2737,3441,BIJAPUR
2009,87,22,48,509,1475,2141,CBPURA
2009,42,16,16,382,1394,1850,CHAMARAJNAGAR
2009,68,26,32,525,2448,3099,CHICKMAGALUR
2009,70,52,48,612,3580,4362,CHITRADURGA
2009,125,28,30,926,3320,4429,DAKSHIN KANNADA
2009,51,32,34,826,2573,3516,DAVANAGERE
2009,42,12,28,940,1344,2366,DHARWAD COMMR.
2009,43,8,24,149,1179,1403,DHARWAD RURAL
2009,33,8,18,193,1005,1257,GADAG
2009,249,64,98,970,4921,6302,GULBARGA
2009,107,44,44,1047,4239,5481,HASSAN
2009,48,10,28,387,1840,2313,HAVERI
2009,22,18,28,212,735,1015,K.G.F.
2009,54,28,26,318,1579,2005,KODAGU
2009,58,20,30,492,1514,2114,KOLAR
2009,42,28,26,302,1658,2056,KOPPAL
2009,146,32,54,1317,4405,5954,MANDYA
2009,76,28,42,1731,2000,3877,MYSORE COMMR.
2009,87,42,28,821,2806,3784,MYSORE RURAL
2009,76,42,36,310,2519,2983,RAICHUR
2009,17,2,0,972,172,1163,RAILWAYS
2009,128,24,42,1331,3252,4777,RAMANAGAR
2009,107,30,76,1203,4545,5961,SHIMOGA
2009,137,38,46,1464,3784,5469,TUMKUR
2009,40,10,6,415,2107,2578,UDUPI
2009,38,18,20,254,2373,2703,UTTAR KANNADA
2009,53,52,28,871,6671,7675,ALAPUZHA
2009,24,40,22,750,8045,8881,ERNAKULAM COMMR.
2009,51,52,22,1427,11161,12713,ERNAKULAM RURAL
2009,35,46,6,661,4507,5255,IDUKKI
2009,49,74,20,681,6116,6940,KANNUR
2009,51,94,16,459,2960,3580,KASARGOD
2009,63,102,42,1188,8071,9466,KOLLAM
2009,37,56,28,1160,6597,7878,KOTTAYAM
2009,15,36,16,952,3186,4205,KOZHIKODE COMMR.
2009,44,66,56,539,4845,5550,KOZHIKODE RURAL
2009,55,70,34,1065,5915,7139,MALAPPURAM
2009,57,98,26,736,7100,8017,PALAKKAD
2009,33,48,22,622,4777,5502,PATHANAMTHITTA
2009,2,0,0,395,144,541,RAILWAYS
2009,61,64,38,1137,8802,10102,THRISSUR
2009,44,80,36,1614,4328,6102,TRIVANDRUM COMMR.
2009,61,114,86,1340,6725,8326,TRIVANDRUM RURAL
2009,16,44,14,293,2002,2369,WAYANADU
2009,110,62,20,167,1091,1450,ALIRAJPUR
2009,35,70,14,267,1077,1463,ANUPPUR
2009,51,76,12,341,1743,2223,ASHOK NAGAR
2009,79,124,16,416,1949,2584,BALAGHAT
2009,45,62,10,415,1466,1998,BARWANI
2009,97,260,60,644,2439,3500,BETUL
2009,155,46,64,676,3018,3959,BHIND
2009,158,304,154,6910,10452,17978,BHOPAL
2009,8,6,6,2085,368,2473,BHOPAL RLY.
2009,27,28,6,274,1014,1349,BURHANPUR
2009,143,128,40,963,3972,5246,CHHATARPUR
2009,95,276,64,890,4139,5464,CHHINDWARA
2009,106,78,36,588,2472,3280,DAMOH
2009,87,40,48,522,2169,2866,DATIYA
2009,85,118,22,1232,3845,5302,DEWAS
2009,153,198,68,1209,4629,6257,DHAR
2009,24,70,4,70,840,1008,DINDORI
2009,63,108,18,583,2596,3368,GUNA
2009,232,146,170,4886,6317,11751,GWALIOR
2009,23,38,14,354,1163,1592,HARDA
2009,93,118,46,958,2745,3960,HOSHANGABAD
2009,340,164,72,9208,12051,21835,INDORE
2009,4,0,2,436,180,622,INDORE RLY.
2009,184,258,88,2680,7753,10963,JABALPUR
2009,2,2,2,826,203,1035,JABALPUR RLY.
2009,37,60,36,318,1356,1807,JHABUA
2009,56,96,26,538,2527,3243,KATNI
2009,67,140,26,813,2410,3456,KHANDWA
2009,96,90,10,1247,3160,4603,KHARGON
2009,37,86,18,201,1454,1796,MANDLA
2009,67,92,60,830,2719,3768,MANDSAUR
2009,143,62,80,967,4064,5316,MORENA
2009,75,104,10,479,2234,2902,NARSINGHPUR
2009,25,68,32,740,1495,2360,NEEMUCH
2009,52,62,12,379,1323,1828,PANNA
2009,99,186,20,686,3207,4198,RAISEN
2009,79,136,66,869,3649,4799,RAJGARH
2009,76,134,38,792,2884,3924,RATLAM
2009,107,146,60,1455,3942,5710,REWA
2009,191,254,88,1507,6935,8975,SAGAR
2009,108,290,46,1399,4353,6196,SATNA
2009,64,122,24,408,2250,2868,SEONI
2009,40,84,22,653,2259,3058,SHAHDOL
2009,74,158,36,1113,2800,4181,SHAJAPUR
2009,34,28,14,180,1177,1433,SHEOPUR
2009,102,110,64,740,3371,4387,SHIVPURI
2009,30,48,28,397,1849,2352,SIDHI
2009,88,126,50,780,2642,3686,SIHORE
2009,51,90,32,449,1633,2255,SINGRAULI
2009,85,134,26,452,2781,3478,TIKAMGARH
2009,197,92,54,2560,6739,9642,UJJAIN
2009,24,58,8,221,1035,1346,UMARIYA
2009,95,160,30,951,3409,4645,VIDISHA
2009,156,110,84,3484,3928,7762,AHMEDNAGAR
2009,111,42,66,2283,2614,5116,AKOLA
2009,42,34,46,1673,1568,3363,AMRAVATI COMMR.
2009,112,98,58,2020,2773,5061,AMRAVATI RURAL
2009,83,44,56,2680,1921,4784,AURANGABAD COMMR.
2009,81,28,10,1131,2169,3419,AURANGABAD RURAL
2009,133,52,72,1481,3074,4812,BEED
2009,34,34,24,1260,1482,2834,BHANDARA
2009,112,54,58,1975,2837,5036,BULDHANA
2009,82,88,38,1755,3190,5153,CHANDRAPUR
2009,81,24,26,915,1939,2985,DHULE
2009,111,24,28,435,845,1443,GADCHIROLI
2009,66,66,40,827,1288,2287,GONDIA
2009,84,20,32,525,1241,1902,HINGOLI
2009,127,60,50,1764,3186,5187,JALGAON
2009,93,44,40,1099,2065,3341,JALNA
2009,82,70,44,1851,2330,4377,KOLHAPUR
2009,106,66,56,1116,2513,3857,LATUR
2009,377,364,298,27176,12442,40657,MUMBAI COMMR.
2009,10,8,6,4199,251,4474,MUMBAI RLY.
2009,167,90,146,4542,4363,9308,NAGPUR COMMR.
2009,7,2,2,1922,259,2192,NAGPUR RLY.
2009,110,66,46,1971,2648,4841,NAGPUR RURAL
2009,173,68,80,1362,3714,5397,NANDED
2009,56,46,26,458,1016,1602,NANDURBAR
2009,69,48,48,4134,1531,5830,NASIK COMMR.
2009,121,92,50,1409,3661,5333,NASIK RURAL
2009,86,38,40,4170,2034,6368,NAVI MUMBAI
2009,56,40,38,788,2033,2955,OSMANABAD
2009,83,60,48,1037,1903,3131,PARBHANI
2009,239,134,210,12268,5656,18507,PUNE COMMR.
2009,6,2,4,919,153,1084,PUNE RLY.
2009,186,144,114,4534,4229,9207,PUNE RURAL
2009,62,42,8,810,1455,2377,RAIGAD
2009,28,28,24,544,1081,1705,RATNAGIRI
2009,99,74,44,1280,1702,3199,SANGLI
2009,85,52,44,2605,2460,5246,SATARA
2009,16,16,8,370,629,1039,SINDHUDURG
2009,37,44,14,873,867,1835,SOLAPUR COMMR.
2009,148,100,86,1622,3146,5102,SOLAPUR RURAL
2009,196,132,174,6889,4026,11417,THANE COMMR.
2009,185,106,68,2914,3083,6356,THANE RURAL
2009,57,82,36,1899,2776,4850,WARDHA
2009,44,50,26,979,1461,2560,WASHIM
2009,134,80,56,2134,3117,5521,YAVATMAL
2009,51,4,14,61,252,382,BISHNUPUR
2009,37,0,0,22,126,185,CHANDEL
2009,25,6,8,25,139,203,CHURACHANDPUR
2009,0,0,0,0,104,104,CID
2009,135,14,112,208,351,820,IMPHAL EAST
2009,188,16,104,565,552,1425,IMPHAL WEST
2009,34,2,12,47,165,260,SENAPATI
2009,10,0,0,7,122,139,TAMENGLONG
2009,104,18,64,93,343,622,THOUBAL
2009,25,2,4,20,128,179,UKHRUL
2009,15,6,6,97,168,292,GARO HILLS EAST
2009,5,0,6,34,122,167,GARO HILLS SOUTH
2009,23,16,32,323,405,799,GARO HILLS WEST
2009,45,48,16,147,293,549,JAINTIA HILLS
2009,38,68,34,576,381,1097,KHASI HILLS EAST
2009,24,40,4,91,201,360,KHASI HILLS WEST
2009,17,46,14,101,223,401,RI-BHOI
2009,22,54,14,1032,389,1511,AIZAWL
2009,8,30,0,183,134,355,CHAMPHAI
2009,4,14,0,175,178,371,KOLASIB
2009,5,10,0,98,178,291,LAWNGTLAI
2009,1,24,2,207,150,384,LUNGLEI
2009,1,18,2,82,136,239,MAMIT
2009,2,6,0,69,138,215,SAIHA
2009,2,10,0,63,131,206,SERCHHIP
2009,23,14,66,495,239,837,DIMAPUR
2009,0,0,4,8,109,121,KIPHIRE
2009,11,12,24,149,157,353,KOHIMA
2009,1,0,0,6,119,126,LONGLENG
2009,8,0,2,52,116,178,MOKOKCHUNG
2009,6,0,0,40,124,170,MON
2009,10,4,2,22,112,150,PEREN
2009,10,0,0,20,121,151,PHEK
2009,1,2,2,6,123,134,TUENSANG
2009,9,6,0,45,124,184,WOKHA
2009,2,6,4,33,118,163,ZUNHEBOTO
2009,128,118,72,992,1880,3190,ANGUL
2009,76,92,124,895,2486,3673,BALASORE
2009,98,50,20,467,960,1595,BARAGARH
2009,64,36,40,421,610,1171,BERHAMPUR
2009,69,92,84,353,1689,2287,BHADRAK
2009,97,92,66,410,1572,2237,BOLANGIR
2009,25,14,2,74,321,436,BOUDH
2009,34,50,96,528,1977,2685,CUTTACK
2009,70,64,54,2373,2494,5055,DCP BBSR
2009,41,28,44,1400,1326,2839,DCP CTC
2009,21,24,16,98,480,639,DEOGARH
2009,79,46,48,543,1138,1854,DHENKANAL
2009,35,18,16,103,392,564,GAJAPATI
2009,207,68,56,513,964,1808,GANJAM
2009,41,62,52,426,1158,1739,JAGATSINGHPUR
2009,86,64,108,700,1627,2585,JAJPUR
2009,51,14,12,607,865,1549,JHARSUGUDA
2009,44,60,48,240,1037,1429,KALAHANDI
2009,44,48,34,200,566,892,KANDHAMAL
2009,30,56,72,324,1081,1563,KENDRAPARA
2009,210,106,98,836,1522,2772,KEONJHAR
2009,50,54,76,396,1166,1742,KHURDA
2009,75,82,62,306,916,1441,KORAPUT
2009,53,30,24,88,257,452,MALKANGIR
2009,162,160,128,572,1432,2454,MAYURBHANJ
2009,41,58,56,319,845,1319,NAYAGARH
2009,55,70,44,176,646,991,NOWRANGPUR
2009,22,34,24,137,591,808,NUAPADA
2009,112,58,96,1019,1913,3198,PURI
2009,38,72,32,205,552,899,RAYAGADA
2009,111,76,46,777,1104,2114,ROURKELA
2009,91,70,32,860,1578,2631,SAMBALPUR
2009,32,34,34,111,413,624,SONEPUR
2009,3,4,6,825,221,1059,SRP(CUTTACK)
2009,9,2,8,455,255,729,SRP(ROURKELA)
2009,77,40,30,391,871,1409,SUNDARGARH
2009,118,30,92,997,1218,2455,AMRITSAR
2009,58,28,36,198,521,841,AMRITSAR RURAL
2009,47,26,14,228,482,797,BARNALA
2009,45,42,24,383,552,1046,BATALA
2009,126,64,72,1019,1170,2451,BHATINDA
2009,49,34,14,254,574,925,FARIDKOT
2009,31,14,22,364,674,1105,FATEHGARH SAHIB
2009,122,86,78,696,1225,2207,FEROZPUR
2009,13,2,0,120,482,617,G.R.P
2009,63,28,64,307,792,1254,GURDASPUR
2009,98,74,62,522,1163,1919,HOSHIARPUR
2009,191,70,192,1845,2065,4363,JALANDHAR
2009,72,42,40,478,764,1396,KAPURTHALA
2009,46,20,26,253,780,1125,KHANNA
2009,169,78,190,1488,1706,3631,LUDHIANA
2009,45,26,52,356,741,1220,LUDHIANA RURAL
2009,64,26,28,163,621,902,MANSA
2009,68,36,38,411,812,1365,MOGA
2009,61,40,22,380,542,1045,MUKTSAR
2009,106,56,112,979,1920,3173,PATIALA
2009,38,26,32,326,640,1062,ROPAR
2009,80,50,52,657,1196,2035,SANGRUR
2009,51,46,74,1177,1005,2353,SAS NGR
2009,37,24,12,270,621,964,SBS NAGAR
2009,69,54,36,189,593,941,TARN TARAN
2009,86,94,186,1624,4465,6455,AJMER
2009,180,202,368,3535,6764,11049,ALWAR
2009,45,80,106,286,1929,2446,BANSWARA
2009,122,110,170,628,2469,3499,BARAN
2009,50,62,58,543,2393,3106,BARMER
2009,149,164,376,2363,6154,9206,BHARATPUR
2009,78,104,218,1827,3687,5914,BHILWARA
2009,118,74,76,720,2933,3921,BIKANER
2009,110,74,230,632,2765,3811,BUNDI
2009,69,88,192,1141,3558,5048,CHITTORGARH
2009,58,66,90,498,2382,3094,CHURU
2009,59,26,184,1857,3752,5878,DAUSA
2009,135,60,134,1130,3216,4675,DHOLPUR
2009,44,58,86,201,1650,2039,DUNGARPUR
2009,14,2,4,1091,453,1564,G.R.P.
2009,133,178,126,782,3983,5202,GANGANAGAR
2009,120,108,98,491,2657,3474,HANUMANGARH
2009,51,58,132,5787,2717,8745,JAIPUR EAST
2009,52,46,152,1899,2121,4270,JAIPUR NORTH
2009,101,98,198,2752,6377,9526,JAIPUR RURAL
2009,41,34,146,4098,2435,6754,JAIPUR SOUTH
2009,11,10,26,293,852,1192,JAISALMER
2009,35,38,68,489,2172,2802,JALORE
2009,97,110,116,1137,3171,4631,JHALAWAR
2009,61,82,120,933,3152,4348,JHUNJHUNU
2009,73,30,136,1814,1974,4027,JODHPUR CITY
2009,55,54,80,572,2283,3044,JODHPUR RURAL
2009,71,92,168,1083,3197,4611,KARAULI
2009,152,46,174,2155,2404,4931,KOTA CITY
2009,81,58,78,440,1788,2445,KOTA RURAL
2009,86,106,178,875,3065,4310,NAGAUR
2009,85,96,202,805,4115,5303,PALI
2009,51,108,126,247,1381,1913,PRATAPGARH
2009,25,22,94,449,2004,2594,RAJSAMAND
2009,43,34,166,1177,2539,3959,SAWAI MADHOPUR
2009,83,72,168,1123,3816,5262,SIKAR
2009,56,36,56,408,1536,2092,SIROHI
2009,45,40,94,798,2778,3755,TONK
2009,143,218,360,1895,5199,7815,UDAIPUR
2009,11,10,4,102,282,409,EAST
2009,2,0,0,4,137,143,NORTH
2009,8,16,4,94,246,368,SOUTH
2009,5,10,4,21,182,222,WEST
2009,62,42,38,225,1874,2241,ARIYALUR
2009,271,78,84,3921,8014,12368,CHENNAI
2009,3,0,0,416,354,773,CHENNAI RLY.
2009,190,92,56,2059,5620,8017,CHENNAISUBURBAN
2009,87,14,62,1239,3806,5208,COIMBATORE RURAL
2009,50,18,46,2555,2814,5483,COIMBATORE URBAN
2009,138,40,68,1041,5919,7206,CUDDALORE
2009,69,14,72,381,3552,4088,DHARMAPURI
2009,146,20,122,832,4155,5275,DINDIGUL
2009,82,32,88,1102,4888,6192,ERODE
2009,126,56,22,790,5063,6057,KANCHIPURAM
2009,115,22,62,1103,3949,5251,KANYAKUMARI
2009,41,14,26,496,2107,2684,KARUR
2009,94,30,72,579,4062,4837,KRISHNAGIRI
2009,150,36,98,880,4286,5450,MADURAI RURAL
2009,78,6,50,1186,2184,3504,MADURAI URBAN
2009,109,14,78,619,3517,4337,NAGAPATTINAM
2009,64,28,88,739,3884,4803,NAMAKKAL
2009,23,6,14,190,1026,1259,NILGIRIS
2009,27,22,26,187,1434,1696,PERAMBALUR
2009,78,10,54,371,2776,3289,PUDUKOTTAI
2009,128,20,112,546,2897,3703,RAMNATHAPURAM
2009,116,64,182,525,5212,6099,SALEM RURAL
2009,47,40,78,722,1927,2814,SALEM URBAN
2009,66,10,60,539,2164,2839,SIVAGANGAI
2009,149,10,72,1992,6068,8291,THANJAVUR
2009,103,18,98,557,4646,5422,THENI
2009,302,88,132,1365,6428,8315,THIRUNELVELI RURAL
2009,79,10,52,675,1390,2206,THIRUNELVELI URBAN
2009,82,24,40,377,3764,4287,THIRUVALLUR
2009,128,24,42,461,3664,4319,THIRUVANNAMALAI
2009,68,2,32,335,2954,3391,THIRUVARUR
2009,220,40,70,1272,4410,6012,THOOTHUGUDI
2009,87,24,122,2125,3798,6156,TIRUPPUR
2009,0,0,0,181,175,356,TRICHY RLY.
2009,86,20,34,415,3629,4184,TRICHY RURAL
2009,39,12,40,1075,2994,4160,TRICHY URBAN
2009,125,36,92,1024,6150,7427,VELLORE
2009,168,124,160,933,6302,7687,VILLUPURAM
2009,105,32,100,890,3678,4805,VIRUDHUNAGAR
2009,24,36,18,101,384,563,DHALAI
2009,49,96,64,239,735,1183,NORTH
2009,39,96,54,293,1085,1567,SOUTH
2009,80,152,106,512,1917,2767,WEST
2009,283,80,486,3818,3586,8253,AGRA
2009,365,116,488,2620,3080,6669,ALIGARH
2009,215,76,296,1845,3343,5775,ALLAHABAD
2009,64,38,112,262,738,1214,AMBEDKAR NAGAR
2009,72,22,88,227,793,1202,AURAIYA
2009,98,34,142,446,1236,1956,AZAMGARH
2009,250,58,192,439,1855,2794,BADAUN
2009,132,30,106,410,1008,1686,BAGHPAT
2009,66,76,178,439,1209,1968,BAHRAICH
2009,59,18,56,319,616,1068,BALLIA
2009,28,16,46,119,336,545,BALRAMPUR
2009,45,46,82,308,1103,1584,BANDA
2009,97,38,214,597,2172,3118,BARABANKI
2009,311,154,336,1449,2997,5247,BAREILLY
2009,30,24,44,197,764,1059,BASTI
2009,119,60,174,493,1925,2771,BIJNOR
2009,248,76,204,747,1659,2934,BULANDSHAHAR
2009,43,6,46,222,628,945,CHANDOLI
2009,27,40,28,118,369,582,CHITRAKOOT DHAM
2009,39,18,88,228,853,1226,DEORIA
2009,160,36,108,633,1378,2315,ETAH
2009,98,10,150,597,1877,2732,ETAWAH
2009,48,44,148,538,1241,2019,FAIZABAD
2009,121,34,138,328,870,1491,FATEHGARH
2009,98,56,106,299,1191,1750,FATEHPUR
2009,223,52,284,944,1966,3469,FIROZABAD
2009,31,2,6,2573,957,3569,G.R.P.
2009,173,48,166,4832,1647,6866,GAUTAMBUDH NAGAR
2009,531,106,982,9407,4910,15936,GHAZIABAD
2009,72,6,42,323,654,1097,GHAZIPUR
2009,96,58,176,410,1103,1843,GONDA
2009,135,86,214,1904,2245,4584,GORAKHPUR
2009,36,32,36,97,347,548,HAMIRPUR
2009,131,58,182,536,2029,2936,HARDOI
2009,101,44,146,454,1136,1881,HATHRAS
2009,91,52,86,349,753,1331,J.P.NAGAR
2009,50,22,66,203,877,1218,JALAUN
2009,105,36,180,429,1491,2241,JAUNPUR
2009,54,28,86,462,735,1365,JHANSI
2009,67,16,112,180,932,1307,KANNAUJ
2009,67,34,176,268,1418,1963,KANPUR DEHAT
2009,227,80,564,2547,4134,7552,KANPUR NAGAR
2009,85,30,84,183,730,1112,KANSHIRAM NAGAR
2009,67,30,82,244,1019,1442,KAUSHAMBI
2009,119,74,176,584,1692,2645,KHIRI
2009,34,18,40,95,914,1101,KUSHI NAGAR
2009,27,26,24,127,513,717,LALITPUR
2009,200,112,646,5841,7024,13823,LUCKNOW
2009,34,34,56,124,662,910,MAHARAJGANJ
2009,22,22,48,141,427,660,MAHOBA
2009,150,32,166,522,1218,2088,MAINPURI
2009,180,40,152,1273,2662,4307,MATHURA
2009,75,30,100,327,684,1216,MAU
2009,340,92,386,2662,3019,6499,MEERUT
2009,38,22,28,287,938,1313,MIRZAPUR
2009,244,138,394,1498,2422,4696,MORADABAD
2009,381,116,324,1286,2502,4609,MUZAFFARNAGAR
2009,54,30,122,212,1538,1956,PILIBHIT
2009,101,44,168,437,1424,2174,PRATAPGARH
2009,103,60,134,391,1653,2341,RAIBAREILLY
2009,175,102,210,948,1320,2755,RAMPUR
2009,125,28,82,801,1645,2681,SAHARANPUR
2009,18,26,58,199,809,1110,SANT KABIRNAGAR
2009,230,86,214,526,1617,2673,SHAHJAHANPUR
2009,18,16,46,136,507,723,SHRAWASTI
2009,22,18,60,245,538,883,SIDHARTHNAGAR
2009,165,122,312,770,2187,3556,SITAPUR
2009,47,50,60,203,698,1058,SONBHADRA
2009,24,6,18,163,379,590,ST.RAVIDASNAGAR
2009,109,32,142,604,1644,2531,SULTANPUR
2009,107,96,192,464,1160,2019,UNNAO
2009,75,20,82,1512,1971,3660,VARANASI
2009,12,8,10,107,236,373,ALMORA
2009,3,6,2,11,149,171,BAGESHWAR
2009,4,2,0,54,166,226,CHAMOLI
2009,9,2,4,27,148,190,CHAMPAWAT
2009,65,60,152,1135,1400,2812,DEHRADUN
2009,125,52,136,895,1388,2596,HARIDWAR
2009,44,28,74,421,640,1207,NAINITAL
2009,11,8,26,94,215,354,PAURI GARHWAL
2009,5,0,2,40,215,262,PITHORAGARH
2009,0,4,4,14,146,168,RUDRA PRAYAG
2009,2,2,6,43,171,224,TEHRI GARHWAL
2009,99,42,120,919,1293,2473,UDHAMSINGH NAGAR
2009,1,8,14,26,166,215,UTTARKASHI
2009,467,332,736,4148,9035,14718,24 PARGANAS NORTH
2009,215,560,256,4220,10584,15835,24 PARGANAS SOUTH
2009,39,26,54,627,955,1701,ASANSOL
2009,97,66,72,491,1163,1889,BANKURA
2009,114,104,104,966,1910,3198,BIRBHUM
2009,181,110,270,1588,4171,6320,BURDWAN
2009,192,278,302,681,2565,4018,COOCHBEHAR
2009,125,98,112,272,1217,1824,DAKSHIN DINAJPUR
2009,52,108,100,1311,1762,3333,DARJEELING
2009,135,96,188,1260,2902,4581,HOOGHLY
2009,106,78,260,1851,4023,6318,HOWRAH
2009,28,2,4,642,187,863,HOWRAH G.R.P.
2009,212,386,412,2752,4201,7963,JALPAIGURI
2009,7,0,0,237,133,377,KHARAGPUR G.R.P.
2009,112,84,258,6324,8230,15008,KOLKATA
2009,226,394,356,730,2801,4507,MALDA
2009,791,1136,816,1874,8968,13585,MURSHIDABAD
2009,507,350,594,2724,5982,10157,NADIA
2009,266,114,158,820,2690,4048,PASCHIM MIDNAPUR
2009,87,82,180,937,2932,4218,PURAB MIDNAPUR
2009,71,106,54,442,1132,1805,PURULIA
2009,17,2,12,469,181,681,SEALDAH G.R.P.
2009,2,0,2,150,135,289,SILIGURI G.R.P.
2009,138,160,200,768,2155,3421,UTTAR DINAJPUR
2009,19,36,32,362,687,1136,ANDAMAN
2009,0,0,0,3,117,120,NICOBAR
2009,40,58,80,3737,1279,5194,CHANDIGARH
2009,15,8,24,180,358,585,D and N HAVELI
2009,9,2,0,96,222,329,DAMAN
2009,0,0,0,23,157,180,DIU
2009,0,0,0,0,297,297,CAW
2009,53,56,186,2891,1051,4237,CENTRAL
2009,9,4,0,9,140,162,CRIME BRANCH
2009,106,104,598,6289,2479,9576,EAST
2009,0,0,0,0,105,105,EOW
2009,14,8,22,1463,186,1693,GRP(RLY)
2009,1,0,4,134,162,301,IGI AIRPORT
2009,8,12,92,1223,722,2057,NEW DELHI
2009,63,38,280,2316,1402,4099,NORTH
2009,130,94,750,4347,1817,7138,NORTH-EAST
2009,104,108,436,4687,1711,7046,NORTH-WEST
2009,118,82,664,4190,2167,7221,OUTER
2009,58,84,266,5317,2168,7893,SOUTH
2009,77,118,636,5535,2748,9114,SOUTH-EAST
2009,92,104,482,2864,1643,5185,SOUTH-WEST
2009,4,0,0,0,117,121,STF
2009,84,126,656,4550,2125,7541,WEST
2009,1,2,0,24,222,249,LAKSHADWEEP
2009,8,0,2,123,726,859,KARAIKAL
2009,54,2,34,1391,3077,4558,PUDUCHERRY
2010,188,96,110,820,3910,5124,ADILABAD
2010,238,40,162,1790,4171,6401,ANANTAPUR
2010,150,88,170,1137,4085,5630,CHITTOOR
2010,139,78,126,1131,4583,6057,CUDDAPAH
2010,271,190,300,9469,8886,19116,CYBERABAD
2010,162,132,102,2004,4439,6839,EAST GODAVARI
2010,9,0,8,444,150,611,GUNTAKAL RLY.
2010,214,76,110,1542,4864,6806,GUNTUR
2010,69,24,54,1630,1998,3775,GUNTUR URBAN
2010,277,90,242,10799,9031,20439,HYDERABAD CITY
2010,225,130,316,1646,6228,8545,KARIMNAGAR
2010,163,124,142,1245,4236,5910,KHAMMAM
2010,159,108,150,1333,4380,6130,KRISHNA
2010,301,98,170,1218,5518,7305,KURNOOL
2010,235,178,174,2726,4494,7807,MAHABOOBNAGAR
2010,155,98,166,1441,3831,5691,MEDAK
2010,186,136,162,1533,6076,8093,NALGONDA
2010,158,56,154,1814,4126,6308,NELLORE
2010,143,124,130,1764,4249,6410,NIZAMABAD
2010,197,58,168,1120,4081,5624,PRAKASHAM
2010,41,20,60,906,1356,2383,RAJAHMUNDRY
2010,59,38,42,310,1384,1833,RANGA REDDY
2010,2,2,2,722,192,920,SECUNDERABAD RLY.
2010,74,70,62,760,4216,5182,SRIKAKULAM
2010,66,20,52,1397,1653,3188,TIRUPATHI URBAN
2010,82,50,174,2899,3545,6750,VIJAYAWADA CITY
2010,4,2,0,731,166,903,VIJAYAWADA RLY.
2010,105,84,54,612,2664,3519,VISAKHA RURAL
2010,49,106,68,2851,5031,8105,VISAKHAPATNAM
2010,66,64,38,667,3220,4055,VIZIANAGARAM
2010,68,56,98,414,2160,2796,WARANGAL
2010,37,34,56,618,1946,2691,WARANGAL URBAN
2010,199,254,284,2905,5370,9012,WEST GODAVARI
2010,1,2,0,17,120,140,ANJAW
2010,6,8,14,118,236,382,CHANGLANG
2010,4,6,6,77,165,258,DIBANG VALLEY
2010,9,0,2,26,125,162,K/KUMEY
2010,6,2,10,67,178,263,KAMENG EAST
2010,10,0,8,32,187,237,KAMENG WEST
2010,11,18,10,84,193,316,LOHIT
2010,12,8,30,270,288,608,PAPUM PARE
2010,5,6,4,26,160,201,RURAL
2010,8,16,14,179,198,415,SIANG EAST
2010,3,2,2,30,126,163,SIANG UPPER
2010,10,12,12,81,249,364,SIANG WEST
2010,6,0,6,51,165,228,SUBANSIRI LOWER
2010,8,10,8,51,195,272,SUBANSIRI UPPER
2010,1,2,0,17,126,146,TAWANG
2010,8,2,8,55,184,257,TIRAP
2010,1,0,0,4,112,117,UPPER DIBANG VALLEY
2010,67,218,354,682,2123,3444,BARPETA
2010,73,46,96,160,441,816,BASKA
2010,42,102,148,355,997,1644,BONGAIGAON
2010,0,0,2,4,122,128,C.I.D.
2010,60,146,346,1358,3313,5223,CACHAR
2010,23,56,90,152,508,829,CHIRANG
2010,34,194,278,457,1777,2740,DARRANG
2010,34,150,156,295,790,1425,DHEMAJI
2010,63,362,482,760,2950,4617,DHUBRI
2010,85,108,272,1093,1490,3048,DIBRUGARH
2010,3,0,14,324,214,555,G.R.P.
2010,31,238,242,427,1794,2732,GOALPARA
2010,73,80,172,496,996,1817,GOLAGHAT
2010,90,140,772,4979,5313,11294,GUWAHATI CITY
2010,25,144,148,339,1112,1768,HAILAKANDI
2010,56,102,136,719,1122,2135,JORHAT
2010,59,102,240,639,1692,2732,KAMRUP
2010,48,38,90,265,465,906,KARBI ANGLONG
2010,44,72,108,342,1102,1668,KARIMGANJ
2010,71,60,156,397,682,1366,KOKRAJHAR
2010,62,78,256,400,1352,2148,LAKHIMPUR
2010,25,148,186,265,940,1564,MORIGAON
2010,25,6,38,100,178,347,N.C.HILLS
2010,150,296,604,1195,4115,6360,NAGAON
2010,41,48,112,426,944,1571,NALBARI
2010,6,14,4,28,186,238,R.P.O.
2010,84,150,284,1035,1326,2879,SIBSAGAR
2010,91,160,382,880,2174,3687,SONITPUR
2010,113,110,224,1308,1260,3015,TINSUKIA
2010,76,74,108,220,636,1114,UDALGURI
2010,95,84,168,617,1804,2768,ARARIA
2010,65,6,26,202,661,960,ARWAL
2010,107,24,116,821,2372,3440,AURANGABAD
2010,102,20,132,277,1207,1738,BAGAHA
2010,115,26,106,371,1479,2097,BANKA
2010,282,40,184,793,3157,4456,BEGUSARAI
2010,66,36,222,817,3008,4149,BETTIAH
2010,119,12,78,515,1476,2200,BHABHUA
2010,208,44,172,1223,2181,3828,BHAGALPUR
2010,147,30,144,1088,3089,4498,BHOJPUR
2010,155,24,110,742,1566,2597,BUXAR
2010,226,36,194,907,3125,4488,DARBHANGA
2010,174,44,218,1695,3358,5489,GAYA
2010,129,36,218,507,2185,3075,GOPALGANJ
2010,4,0,14,317,162,497,JAMALPUR RLY.
2010,224,40,114,408,1333,2119,JAMUI
2010,56,16,84,584,1405,2145,JEHANABAD
2010,137,110,238,489,1892,2866,KATIHAR
2010,15,2,16,464,249,746,KATIHAR RLY.
2010,167,10,72,290,1540,2079,KHAGARIA
2010,77,48,100,329,941,1495,KISHANGANJ
2010,88,20,80,309,1029,1526,LAKHISARAI
2010,135,22,122,368,1505,2152,MADHEPURA
2010,83,60,282,1032,3562,5019,MADHUBANI
2010,586,50,346,1272,3898,6152,MOTIHARI
2010,180,22,160,554,1463,2379,MUNGER
2010,159,104,458,2227,4758,7706,MUZAFFARPUR
2010,34,2,14,631,250,931,MUZAFFARPUR RLY.
2010,192,52,186,776,3562,4768,NALANDA
2010,70,16,72,131,1042,1331,NAUGACHIA
2010,90,22,130,411,1915,2568,NAWADAH
2010,324,100,566,6074,9417,16481,PATNA
2010,18,2,20,1480,456,1976,PATNA RLY.
2010,210,80,212,448,2208,3158,PURNEA
2010,214,54,230,1429,3252,5179,ROHTAS
2010,141,14,102,302,1373,1932,SAHARSA
2010,334,72,378,910,2970,4664,SAMASTIPUR
2010,202,46,272,1165,2940,4625,SARAN
2010,24,4,44,197,826,1095,SHEIKHPURA
2010,24,6,34,161,488,713,SHEOHAR
2010,98,18,120,1096,3045,4377,SITAMARHI
2010,147,38,266,735,2371,3557,SIWAN
2010,81,38,134,333,1365,1951,SUPAUL
2010,173,60,394,1256,3207,5090,VAISHALI
2010,50,122,24,111,705,1012,BALRAMPUR
2010,155,138,76,2190,4785,7344,BILASPUR
2010,175,6,20,52,268,521,BIZAPUR
2010,146,18,16,127,530,837,DANTEWARA
2010,23,80,20,415,1065,1603,DHAMTARI
2010,143,212,78,2631,7214,10278,DURG
2010,4,2,4,669,160,839,GRP RAIPUR
2010,114,96,34,408,1756,2408,JAGDALPUR
2010,68,78,18,806,2220,3190,JANJGIR
2010,77,138,48,243,936,1442,JASHPUR
2010,30,38,16,214,1176,1474,KABIRDHAM
2010,93,36,22,180,789,1120,KANKER
2010,53,64,14,629,2078,2838,KORBA
2010,45,116,42,434,1365,2002,KORIYA
2010,49,52,14,462,1256,1833,MAHASAMUND
2010,59,6,18,32,190,305,NARAYANPUR
2010,104,104,38,985,2216,3447,RAIGARH
2010,188,272,98,3974,7144,11676,RAIPUR
2010,86,86,36,582,2307,3097,RAJNANDGAON
2010,89,206,50,596,1577,2518,SARGUJA
2010,70,154,32,270,1261,1787,SURAJPUR
2010,37,24,20,1433,1000,2514,NORTH GOA
2010,25,48,30,1044,722,1869,SOUTH GOA
2010,148,98,414,10950,14299,25909,AHMEDABAD COMMR.
2010,48,16,88,738,2835,3725,AHMEDABAD RURAL
2010,12,2,0,14,236,264,AHWA-DANG
2010,24,20,130,503,1775,2452,AMRELI
2010,32,30,90,1001,2804,3957,ANAND
2010,52,18,54,776,2334,3234,BHARUCH
2010,79,16,124,1227,3267,4713,BHAVNAGAR
2010,3,2,0,2,105,112,CID CRIME
2010,55,6,108,483,1489,2141,DAHOD
2010,25,26,58,1185,5072,6366,GANDHINAGAR
2010,45,36,104,543,3281,4009,HIMATNAGAR
2010,70,28,64,903,3326,4391,JAMNAGAR
2010,67,38,136,1330,3740,5311,JUNAGADH
2010,45,32,126,608,4828,5639,KHEDA NORTH
2010,54,16,72,966,3616,4724,KUTCH
2010,37,16,132,1467,3678,5330,MEHSANA
2010,19,14,8,79,836,956,NARMADA
2010,24,12,38,234,960,1268,NAVSARI
2010,63,76,220,1403,3649,5411,PALANPUR
2010,57,26,116,479,3305,3983,PANCHMAHAL
2010,20,22,76,638,2031,2787,PATAN
2010,16,4,24,126,843,1013,PORBANDAR
2010,60,24,78,2364,2599,5125,RAJKOT COMMR.
2010,64,48,138,683,3228,4161,RAJKOT RURAL
2010,106,46,164,3796,5050,9162,SURAT COMMR.
2010,49,12,50,434,1425,1970,SURAT RURAL
2010,36,58,58,501,2497,3150,SURENDRANAGAR
2010,21,6,2,137,654,820,TAPI
2010,48,14,72,3405,3320,6859,VADODARA COMMR.
2010,82,32,110,517,2242,2983,VADODARA RURAL
2010,39,22,28,671,1422,2182,VALSAD
2010,10,0,12,1084,275,1381,W.RLY
2010,65,60,66,1624,1673,3488,AMBALA
2010,99,60,104,1394,1788,3445,BHIWANI
2010,119,102,204,3720,2344,6489,FARIDABAD
2010,60,42,66,620,937,1725,FATEHABAD
2010,26,2,6,967,759,1760,GRP
2010,143,90,116,6892,2440,9681,GURGAON
2010,165,50,168,2042,2218,4643,HISSAR
2010,101,72,84,1289,1196,2742,JHAJJAR
2010,93,58,70,1414,1383,3018,JIND
2010,54,56,54,798,1074,2036,KAITHAL
2010,99,104,66,1983,2029,4281,KARNAL
2010,55,72,68,1718,1404,3317,KURUKSHETRA
2010,50,56,80,835,1250,2271,MAHENDRAGARH
2010,62,56,72,927,1275,2392,MEWAT
2010,78,82,82,1348,1410,3000,PALWAL
2010,26,20,32,806,687,1571,PANCHKULA
2010,63,110,130,1934,1536,3773,PANIPAT
2010,58,50,66,1347,1477,2998,REWARI
2010,125,102,64,2054,1638,3983,ROHTAK
2010,78,78,94,983,1300,2533,SIRSA
2010,147,54,150,2264,1891,4506,SONIPAT
2010,75,64,84,1147,1215,2585,YAMUNANAGAR
2010,15,10,18,120,358,521,BADDIPOLICEDIST
2010,19,30,16,167,1045,1277,BILASPUR
2010,9,26,44,173,562,814,CHAMBA
2010,0,0,0,0,109,109,CID
2010,1,0,0,6,116,123,G.R.P.
2010,15,22,38,120,926,1121,HAMIRPUR
2010,39,44,76,423,1978,2560,KANGRA
2010,4,4,4,25,265,302,KINNAUR
2010,16,34,18,123,750,941,KULLU
2010,1,0,0,10,163,174,LAHAUL-SPITI
2010,22,38,38,248,1529,1875,MANDI
2010,26,42,46,448,1456,2018,SHIMLA
2010,15,30,28,159,723,955,SIRMAUR
2010,11,22,26,230,775,1064,SOLAN
2010,13,18,36,180,910,1157,UNA
2010,22,14,150,383,915,1484,ANANTNAG
2010,4,4,34,92,479,613,AWANTIPORA
2010,27,8,90,142,428,695,BANDIPORA
2010,20,14,114,224,749,1121,BARAMULLA
2010,27,14,134,657,856,1688,BUDGAM
2010,0,0,0,0,105,105,CRIME JAMMU
2010,0,0,0,0,104,104,CRIME KASHMIR
2010,37,42,118,142,719,1058,DODA
2010,7,2,30,79,341,459,GANDERBAL
2010,46,2,72,114,313,547,HANDWARA
2010,109,72,162,1205,2955,4503,JAMMU
2010,1,0,2,33,213,249,KARGIL
2010,31,34,38,186,930,1219,KATHUA
2010,33,6,52,61,325,477,KISHTWAR
2010,21,8,90,190,538,847,KULGAM
2010,32,6,66,159,424,687,KUPWARA
2010,2,4,8,20,232,266,LEH
2010,49,40,78,85,849,1101,POONCH
2010,14,16,66,202,521,819,PULWAMA
2010,0,0,2,25,125,152,RAILWAYS
2010,1,2,0,16,114,133,RAILWAYS
2010,51,72,94,150,1275,1642,RAJOURI
2010,12,12,34,98,620,776,RAMBAN
2010,20,16,24,112,514,686,REASI
2010,22,10,8,114,646,800,SAMBA
2010,26,18,94,273,378,789,SHOPIAN
2010,97,18,76,356,421,968,SOPORE
2010,201,26,136,1254,1488,3105,SRINAGAR
2010,16,30,20,121,974,1161,UDHAMPUR
2010,77,56,128,1425,1809,3495,BOKARO
2010,166,96,48,343,543,1196,CHAIBASA
2010,67,22,52,203,771,1115,CHATRA
2010,75,66,56,753,1155,2105,DEOGHAR
2010,89,64,190,2101,2392,4836,DHANBAD
2010,5,2,8,387,211,613,DHANBAD RLY.
2010,73,104,76,576,1082,1911,DUMKA
2010,152,42,54,230,996,1474,GARHWA
2010,114,74,116,722,1987,3013,GIRIDIH
2010,161,52,84,360,1050,1707,GODDA
2010,219,114,88,202,544,1167,GUMLA
2010,119,60,106,556,1697,2538,HAZARIBAGH
2010,149,76,178,2116,2057,4576,JAMSHEDPUR
2010,8,0,8,340,160,516,JAMSHEDPUR RLY.
2010,79,18,18,153,414,682,JAMTARA
2010,78,4,14,111,219,426,KHUNTI
2010,73,30,46,206,721,1076,KODERMA
2010,75,32,50,180,315,652,LATEHAR
2010,35,78,48,130,384,675,LOHARDAGGA
2010,36,90,34,184,599,943,PAKUR
2010,240,54,126,488,1440,2348,PALAMU
2010,50,26,46,261,718,1101,RAMGARH
2010,238,184,256,3735,3199,7612,RANCHI
2010,122,102,66,244,605,1139,SAHEBGANJ
2010,114,64,32,480,471,1161,SARAIKELA
2010,103,36,28,114,248,529,SIMDEGA
2010,79,18,22,414,1808,2341,BAGALKOT
2010,711,130,1026,23424,14622,39913,BANGALORE COMMR.
2010,150,32,60,1731,3327,5300,BANGALORE RURAL
2010,230,84,124,1450,5857,7745,BELGAUM
2010,98,24,40,727,2765,3654,BELLARY
2010,80,16,52,434,3213,3795,BIDAR
2010,108,26,86,425,2734,3379,BIJAPUR
2010,80,18,60,656,1804,2618,CBPURA
2010,49,24,12,348,1686,2119,CHAMARAJNAGAR
2010,58,38,56,514,2712,3378,CHICKMAGALUR
2010,74,52,78,695,4066,4965,CHITRADURGA
2010,90,32,32,1048,3293,4495,DAKSHIN KANNADA
2010,54,32,40,699,2475,3300,DAVANAGERE
2010,33,2,40,891,1543,2509,DHARWAD COMMR.
2010,61,16,28,163,1337,1605,DHARWAD RURAL
2010,38,12,16,178,986,1230,GADAG
2010,192,68,150,1044,3748,5202,GULBARGA
2010,144,46,68,1110,5100,6468,HASSAN
2010,51,12,46,329,1941,2379,HAVERI
2010,28,14,32,244,851,1169,K.G.F.
2010,67,40,30,365,1857,2359,KODAGU
2010,94,24,36,519,1517,2190,KOLAR
2010,55,20,42,341,1659,2117,KOPPAL
2010,145,60,94,1498,5329,7126,MANDYA
2010,81,14,48,2124,1822,4089,MYSORE COMMR.
2010,152,86,74,1013,3509,4834,MYSORE RURAL
2010,96,62,76,391,2821,3446,RAICHUR
2010,14,2,4,906,191,1117,RAILWAYS
2010,161,28,76,1352,3373,4990,RAMANAGAR
2010,92,34,62,1097,4844,6129,SHIMOGA
2010,145,50,58,1664,3787,5704,TUMKUR
2010,32,24,14,470,2333,2873,UDUPI
2010,39,22,26,303,2689,3079,UTTAR KANNADA
2010,74,10,40,199,1326,1649,YADGIRI
2010,54,80,42,794,6895,7865,ALAPUZHA
2010,15,40,16,596,25035,25702,ERNAKULAM COMMR.
2010,42,84,28,793,11404,12351,ERNAKULAM RURAL
2010,52,66,14,413,8000,8545,IDUKKI
2010,45,46,22,535,5222,5870,KANNUR
2010,17,46,18,346,2813,3240,KASARGOD
2010,70,110,72,1140,10478,11870,KOLLAM
2010,40,92,22,696,7131,7981,KOTTAYAM
2010,10,32,22,998,3138,4200,KOZHIKODE COMMR.
2010,47,70,34,410,6770,7331,KOZHIKODE RURAL
2010,48,98,42,890,8127,9205,MALAPPURAM
2010,66,98,22,566,9701,10453,PALAKKAD
2010,32,58,22,494,4440,5046,PATHANAMTHITTA
2010,1,0,2,472,173,648,RAILWAYS
2010,67,98,32,813,10346,11356,THRISSUR
2010,31,54,44,1190,4276,5595,TRIVANDRUM COMMR.
2010,68,136,62,1015,7167,8448,TRIVANDRUM RURAL
2010,19,60,6,212,2511,2808,WAYANADU
2010,110,54,14,180,1154,1512,ALIRAJPUR
2010,43,70,12,275,1108,1508,ANUPPUR
2010,58,90,18,336,2281,2783,ASHOK NAGAR
2010,56,104,14,295,2286,2755,BALAGHAT
2010,72,64,8,386,1608,2138,BARWANI
2010,85,288,50,502,2548,3473,BETUL
2010,156,60,22,513,2692,3443,BHIND
2010,144,212,132,6076,9682,16246,BHOPAL
2010,3,4,2,1781,325,2115,BHOPAL RLY.
2010,21,44,4,258,1096,1423,BURHANPUR
2010,140,110,52,865,3722,4889,CHHATARPUR
2010,113,204,34,774,4269,5394,CHHINDWARA
2010,114,82,44,498,2749,3487,DAMOH
2010,120,54,22,401,2105,2702,DATIYA
2010,114,178,56,1571,4429,6348,DEWAS
2010,137,178,84,1179,4635,6213,DHAR
2010,22,62,4,91,870,1049,DINDORI
2010,71,112,24,611,2853,3671,GUNA
2010,275,142,204,5400,7240,13261,GWALIOR
2010,42,80,18,313,1108,1561,HARDA
2010,91,146,76,1002,3350,4665,HOSHANGABAD
2010,257,208,112,8780,12654,22011,INDORE
2010,2,0,2,336,200,540,INDORE RLY.
2010,176,260,68,1966,8253,10723,JABALPUR
2010,2,10,2,799,186,999,JABALPUR RLY.
2010,52,70,28,351,1661,2162,JHABUA
2010,71,138,32,502,2649,3392,KATNI
2010,71,92,30,625,2499,3317,KHANDWA
2010,89,142,28,923,3326,4508,KHARGON
2010,46,112,14,151,1610,1933,MANDLA
2010,56,116,48,698,2580,3498,MANDSAUR
2010,151,80,40,876,4158,5305,MORENA
2010,81,130,12,417,2649,3289,NARSINGHPUR
2010,38,24,28,587,1579,2256,NEEMUCH
2010,46,94,22,403,1661,2226,PANNA
2010,98,172,68,635,3757,4730,RAISEN
2010,64,146,68,739,3693,4710,RAJGARH
2010,102,176,48,844,3400,4570,RATLAM
2010,95,162,90,1306,4392,6045,REWA
2010,213,240,134,1508,6804,8899,SAGAR
2010,122,178,54,1212,4201,5767,SATNA
2010,59,142,42,444,2407,3094,SEONI
2010,51,122,32,517,2403,3125,SHAHDOL
2010,72,112,38,967,2458,3647,SHAJAPUR
2010,30,22,20,147,1125,1344,SHEOPUR
2010,86,146,56,599,3725,4612,SHIVPURI
2010,52,88,58,454,2137,2789,SIDHI
2010,93,140,64,712,3285,4294,SIHORE
2010,52,92,48,428,1719,2339,SINGRAULI
2010,59,156,38,506,3157,3916,TIKAMGARH
2010,197,154,108,2436,6752,9647,UJJAIN
2010,18,46,4,135,1121,1324,UMARIYA
2010,112,162,44,880,3775,4973,VIDISHA
2010,197,114,116,3834,4273,8534,AHMEDNAGAR
2010,112,50,50,2485,2741,5438,AKOLA
2010,41,40,62,2273,1656,4072,AMRAVATI COMMR.
2010,101,80,62,1985,3121,5349,AMRAVATI RURAL
2010,124,46,80,2518,2078,4846,AURANGABAD COMMR.
2010,82,32,32,1340,2251,3737,AURANGABAD RURAL
2010,160,56,88,1457,2780,4541,BEED
2010,31,48,30,1122,1508,2739,BHANDARA
2010,107,58,42,1505,2818,4530,BULDHANA
2010,85,86,42,1615,2789,4617,CHANDRAPUR
2010,102,36,24,1061,2152,3375,DHULE
2010,88,32,22,359,788,1289,GADCHIROLI
2010,44,56,36,860,1324,2320,GONDIA
2010,74,28,12,503,1456,2073,HINGOLI
2010,165,98,82,2142,3548,6035,JALGAON
2010,94,22,26,1141,2028,3311,JALNA
2010,82,54,44,1689,2305,4174,KOLHAPUR
2010,106,56,62,1195,2515,3934,LATUR
2010,398,388,388,29936,13334,44444,MUMBAI COMMR.
2010,13,4,8,4135,243,4403,MUMBAI RLY.
2010,157,116,114,4348,4516,9251,NAGPUR COMMR.
2010,13,2,6,1938,209,2168,NAGPUR RLY.
2010,115,78,60,1776,2667,4696,NAGPUR RURAL
2010,149,72,104,1574,3833,5732,NANDED
2010,57,40,28,423,1210,1758,NANDURBAR
2010,69,60,54,4446,1612,6241,NASIK COMMR.
2010,140,106,56,1715,3598,5615,NASIK RURAL
2010,84,54,46,4938,2382,7504,NAVI MUMBAI
2010,75,56,58,918,1951,3058,OSMANABAD
2010,90,40,72,1225,2035,3462,PARBHANI
2010,223,182,258,11111,6007,17781,PUNE COMMR.
2010,1,0,4,766,142,913,PUNE RLY.
2010,222,144,96,4089,4512,9063,PUNE RURAL
2010,66,30,22,729,1395,2242,RAIGAD
2010,33,56,18,623,1104,1834,RATNAGIRI
2010,94,98,52,1251,1802,3297,SANGLI
2010,102,54,84,2257,2531,5028,SATARA
2010,21,18,10,377,574,1000,SINDHUDURG
2010,36,24,28,956,966,2010,SOLAPUR COMMR.
2010,115,126,74,1812,3204,5331,SOLAPUR RURAL
2010,179,186,186,7650,4123,12324,THANE COMMR.
2010,181,94,88,3530,3311,7204,THANE RURAL
2010,70,88,52,1854,2587,4651,WARDHA
2010,61,24,34,911,1450,2480,WASHIM
2010,111,66,104,2159,3231,5671,YAVATMAL
2010,42,12,40,78,289,461,BISHNUPUR
2010,8,0,2,18,137,165,CHANDEL
2010,15,2,8,35,149,209,CHURACHANDPUR
2010,0,0,0,0,104,104,CID
2010,70,12,86,203,310,681,IMPHAL EAST
2010,132,20,142,534,603,1431,IMPHAL WEST
2010,13,2,44,83,186,328,SENAPATI
2010,1,0,2,18,137,158,TAMENGLONG
2010,61,18,74,112,317,582,THOUBAL
2010,8,2,0,17,144,171,UKHRUL
2010,19,10,10,100,154,293,GARO HILLS EAST
2010,11,8,10,23,127,179,GARO HILLS SOUTH
2010,31,30,48,408,319,836,GARO HILLS WEST
2010,53,66,16,168,270,573,JAINTIA HILLS
2010,41,82,32,674,378,1207,KHASI HILLS EAST
2010,24,56,12,112,199,403,KHASI HILLS WEST
2010,15,46,14,119,241,435,RI-BHOI
2010,33,68,6,1141,351,1599,AIZAWL
2010,9,40,0,223,141,413,CHAMPHAI
2010,7,16,4,162,161,350,KOLASIB
2010,8,12,2,116,156,294,LAWNGTLAI
2010,7,18,0,276,144,445,LUNGLEI
2010,7,12,2,61,145,227,MAMIT
2010,3,6,4,62,140,215,SAIHA
2010,1,12,0,49,139,201,SERCHHIP
2010,26,8,82,470,251,837,DIMAPUR
2010,4,0,0,15,115,134,KIPHIRE
2010,13,6,12,175,154,360,KOHIMA
2010,2,0,0,2,113,117,LONGLENG
2010,6,4,2,51,138,201,MOKOKCHUNG
2010,0,0,0,23,104,127,MON
2010,2,0,0,20,110,132,PEREN
2010,5,2,2,27,121,157,PHEK
2010,3,2,0,26,117,148,TUENSANG
2010,10,4,2,43,111,170,WOKHA
2010,9,6,0,70,120,205,ZUNHEBOTO
2010,120,78,84,852,1940,3074,ANGUL
2010,93,96,150,871,2349,3559,BALASORE
2010,125,72,54,517,1116,1884,BARAGARH
2010,103,22,32,512,718,1387,BERHAMPUR
2010,69,66,104,337,1605,2181,BHADRAK
2010,153,96,38,458,1337,2082,BOLANGIR
2010,25,14,14,64,339,456,BOUDH
2010,44,52,52,519,1955,2622,CUTTACK
2010,100,86,82,2639,2378,5285,DCP BBSR
2010,31,34,62,1229,1469,2825,DCP CTC
2010,30,22,8,71,470,601,DEOGARH
2010,106,38,72,617,1041,1874,DHENKANAL
2010,24,12,34,59,358,487,GAJAPATI
2010,285,96,94,516,890,1881,GANJAM
2010,43,48,78,510,1239,1918,JAGATSINGHPUR
2010,77,60,76,754,1540,2507,JAJPUR
2010,54,20,8,724,825,1631,JHARSUGUDA
2010,54,120,70,265,1130,1639,KALAHANDI
2010,42,54,60,163,510,829,KANDHAMAL
2010,88,76,72,433,1005,1674,KENDRAPARA
2010,147,90,74,870,1532,2713,KEONJHAR
2010,34,82,78,400,1205,1799,KHURDA
2010,70,82,46,246,955,1399,KORAPUT
2010,71,28,20,89,274,482,MALKANGIR
2010,150,152,146,664,1373,2485,MAYURBHANJ
2010,47,40,48,531,896,1562,NAYAGARH
2010,40,96,66,204,708,1114,NOWRANGPUR
2010,21,26,22,172,597,838,NUAPADA
2010,137,44,94,933,1923,3131,PURI
2010,48,56,66,218,574,962,RAYAGADA
2010,109,52,38,653,1055,1907,ROURKELA
2010,85,54,34,915,1576,2664,SAMBALPUR
2010,29,34,10,151,472,696,SONEPUR
2010,4,0,4,814,201,1023,SRP(CUTTACK)
2010,8,4,4,588,242,846,SRP(ROURKELA)
2010,78,48,38,395,869,1428,SUNDARGARH
2010,80,32,58,272,822,1264,AMRITSAR RURAL
2010,54,24,18,217,574,887,BARNALA
2010,43,52,52,336,618,1101,BATALA
2010,123,58,80,906,983,2150,BHATINDA
2010,124,48,102,627,1060,1961,CP AMRITSAR
2010,80,44,114,1200,1050,2488,CP JALANDHAR
2010,182,110,304,2049,1977,4622,CP LUDHIANA
2010,47,20,14,308,622,1011,FARIDKOT
2010,23,22,32,295,703,1075,FATEHGARH SAHIB
2010,113,78,70,562,1169,1992,FEROZPUR
2010,11,0,4,95,426,536,G.R.P
2010,52,60,82,264,919,1377,GURDASPUR
2010,104,52,76,560,1073,1865,HOSHIARPUR
2010,119,78,66,712,1097,2072,JALANDHAR RURAL
2010,81,24,50,406,754,1315,KAPURTHALA
2010,35,14,30,310,738,1127,KHANNA
2010,46,22,22,248,596,934,LUDHIANA RURAL
2010,75,44,26,197,551,893,MANSA
2010,81,36,44,562,722,1445,MOGA
2010,53,24,30,412,589,1108,MUKTSAR
2010,94,52,74,988,2052,3260,PATIALA
2010,44,28,36,379,789,1276,ROPAR
2010,92,62,38,682,1314,2188,SANGRUR
2010,41,34,70,850,1067,2062,SAS NGR
2010,39,34,32,301,486,892,SBS NAGAR
2010,65,40,54,264,570,993,TARN TARAN
2010,89,94,210,1487,4157,6037,AJMER
2010,113,210,328,4556,6122,11329,ALWAR
2010,49,122,114,293,1852,2430,BANSWARA
2010,82,96,144,516,2270,3108,BARAN
2010,53,68,66,713,2383,3283,BARMER
2010,169,166,406,2993,5852,9586,BHARATPUR
2010,61,96,286,1819,3445,5707,BHILWARA
2010,104,82,86,817,2627,3716,BIKANER
2010,73,62,186,586,2521,3428,BUNDI
2010,72,84,222,1259,3433,5070,CHITTORGARH
2010,74,98,78,539,2330,3119,CHURU
2010,72,48,194,1886,3752,5952,DAUSA
2010,120,44,154,1265,3331,4914,DHOLPUR
2010,34,52,104,233,1584,2007,DUNGARPUR
2010,9,0,2,780,313,1104,G.R.P. AJMER
2010,3,4,0,184,154,345,G.R.P. JODHPUR
2010,119,144,204,882,3580,4929,GANGANAGAR
2010,119,112,100,451,2646,3428,HANUMANGARH
2010,44,56,158,5398,2734,8390,JAIPUR EAST
2010,47,50,134,1781,2058,4070,JAIPUR NORTH
2010,95,54,218,2233,5825,8425,JAIPUR RURAL
2010,42,36,122,3512,2422,6134,JAIPUR SOUTH
2010,9,6,22,350,883,1270,JAISALMER
2010,31,26,76,448,2078,2659,JALORE
2010,111,124,124,1008,2918,4285,JHALAWAR
2010,87,98,126,752,2637,3700,JHUNJHUNU
2010,81,54,106,1582,2127,3950,JODHPUR CITY
2010,56,34,98,666,2319,3173,JODHPUR RURAL
2010,84,84,182,1474,3309,5133,KARAULI
2010,149,66,160,1785,2378,4538,KOTA CITY
2010,44,72,82,381,1709,2288,KOTA RURAL
2010,85,120,138,1076,2928,4347,NAGAUR
2010,75,106,204,893,4020,5298,PALI
2010,62,112,134,238,1577,2123,PRATAPGARH
2010,27,28,62,450,1871,2438,RAJSAMAND
2010,50,32,172,1016,2662,3932,SAWAI MADHOPUR
2010,93,104,228,1141,3524,5090,SIKAR
2010,65,40,68,359,1416,1948,SIROHI
2010,42,36,100,577,2500,3255,TONK
2010,184,222,372,1976,5489,8243,UDAIPUR
2010,9,10,8,111,222,360,EAST
2010,2,0,0,7,145,154,NORTH
2010,10,18,2,55,190,275,SOUTH
2010,2,8,2,13,197,222,WEST
2010,65,40,52,207,1769,2133,ARIYALUR
2010,261,94,94,3541,8025,12015,CHENNAI
2010,7,0,0,523,439,969,CHENNAI RLY.
2010,223,58,60,1978,6959,9278,CHENNAISUBURBAN
2010,91,26,124,1127,3952,5320,COIMBATORE RURAL
2010,49,30,44,2336,2754,5213,COIMBATORE URBAN
2010,173,54,78,567,5667,6539,CUDDALORE
2010,86,30,94,414,3390,4014,DHARMAPURI
2010,148,18,86,933,4505,5690,DINDIGUL
2010,89,30,128,1135,5831,7213,ERODE
2010,110,34,18,667,5253,6082,KANCHIPURAM
2010,142,24,114,945,3880,5105,KANYAKUMARI
2010,70,20,108,571,2558,3327,KARUR
2010,82,40,128,574,4066,4890,KRISHNAGIRI
2010,137,34,116,953,4435,5675,MADURAI RURAL
2010,84,6,30,1142,1888,3150,MADURAI URBAN
2010,105,18,76,428,3644,4271,NAGAPATTINAM
2010,71,20,96,601,4183,4971,NAMAKKAL
2010,27,14,16,212,1198,1467,NILGIRIS
2010,43,10,20,242,1368,1683,PERAMBALUR
2010,146,14,108,651,4191,5110,PUDUKOTTAI
2010,82,32,122,472,3043,3751,RAMNATHAPURAM
2010,143,106,280,603,7806,8938,SALEM RURAL
2010,45,42,88,748,2713,3636,SALEM URBAN
2010,65,2,64,510,2237,2878,SIVAGANGAI
2010,206,14,84,2185,5359,7848,THANJAVUR
2010,164,36,186,829,4403,5618,THENI
2010,298,96,130,1164,6527,8215,THIRUNELVELI RURAL
2010,90,32,22,634,1207,1985,THIRUNELVELI URBAN
2010,94,36,34,368,3170,3702,THIRUVALLUR
2010,132,30,110,604,4062,4938,THIRUVANNAMALAI
2010,59,24,44,495,3636,4258,THIRUVARUR
2010,252,64,64,938,4045,5363,THOOTHUGUDI
2010,102,20,104,1928,3963,6117,TIRUPPUR
2010,1,0,0,164,208,373,TRICHY RLY.
2010,113,16,48,500,4101,4778,TRICHY RURAL
2010,46,8,54,936,3155,4199,TRICHY URBAN
2010,138,60,136,1554,7139,9027,VELLORE
2010,147,100,164,688,5955,7054,VILLUPURAM
2010,130,40,116,728,4147,5161,VIRUDHUNAGAR
2010,23,66,28,125,449,691,DHALAI
2010,0,0,0,7,105,112,G.R.P.
2010,32,102,50,207,735,1126,NORTH
2010,50,72,54,303,1285,1764,SOUTH
2010,108,236,96,576,1866,2882,WEST
2010,244,52,504,3908,3783,8491,AGRA
2010,297,126,548,2497,2963,6431,ALIGARH
2010,225,66,272,2111,3061,5735,ALLAHABAD
2010,62,40,114,303,811,1330,AMBEDKAR NAGAR
2010,51,22,100,213,809,1195,AURAIYA
2010,109,46,156,509,1189,2009,AZAMGARH
2010,184,44,162,371,1612,2373,BADAUN
2010,102,28,92,376,845,1443,BAGHPAT
2010,104,50,264,519,1418,2355,BAHRAICH
2010,53,8,64,233,574,932,BALLIA
2010,32,22,58,80,333,525,BALRAMPUR
2010,57,44,84,268,848,1301,BANDA
2010,78,44,180,452,1676,2430,BARABANKI
2010,257,88,364,1214,2764,4687,BAREILLY
2010,35,16,60,140,712,963,BASTI
2010,140,80,234,727,1891,3072,BIJNOR
2010,258,48,296,928,1917,3447,BULANDSHAHAR
2010,42,6,40,133,687,908,CHANDOLI
2010,23,30,34,152,355,594,CHITRAKOOT DHAM
2010,58,60,158,226,1014,1516,CSM NAGAR
2010,42,8,46,152,712,960,DEORIA
2010,149,22,126,494,1437,2228,ETAH
2010,72,8,104,419,1521,2124,ETAWAH
2010,54,32,142,525,1258,2011,FAIZABAD
2010,92,22,112,243,606,1075,FATEHGARH
2010,119,66,142,307,1370,2004,FATEHPUR
2010,177,36,198,662,1792,2865,FIROZABAD
2010,49,2,30,4947,1343,6371,G.R.P.
2010,205,78,214,6110,2054,8661,GAUTAMBUDH NAGAR
2010,436,88,732,8497,4137,13890,GHAZIABAD
2010,78,10,38,247,535,908,GHAZIPUR
2010,82,18,154,437,1325,2016,GONDA
2010,187,90,458,2589,2859,6183,GORAKHPUR
2010,34,12,30,153,388,617,HAMIRPUR
2010,98,40,148,313,1871,2470,HARDOI
2010,117,48,158,478,1016,1817,HATHRAS
2010,99,48,114,357,933,1551,J.P.NAGAR
2010,48,10,62,177,722,1019,JALAUN
2010,95,24,130,321,1362,1932,JAUNPUR
2010,75,18,76,305,771,1245,JHANSI
2010,63,14,92,126,779,1074,KANNAUJ
2010,259,84,632,2721,4004,7700,KANPUR NAGAR
2010,88,20,92,189,608,997,KANSHIRAM NAGAR
2010,54,24,80,180,961,1299,KAUSHAMBI
2010,145,52,178,502,1698,2575,KHIRI
2010,51,22,54,128,1000,1255,KUSHI NAGAR
2010,14,14,24,115,551,718,LALITPUR
2010,203,150,656,6281,7007,14297,LUCKNOW
2010,30,32,90,88,838,1078,MAHARAJGANJ
2010,37,18,44,138,473,710,MAHOBA
2010,147,30,158,309,1201,1845,MAINPURI
2010,173,48,174,1395,2961,4751,MATHURA
2010,79,20,96,289,759,1243,MAU
2010,371,128,390,4300,3290,8479,MEERUT
2010,20,4,8,183,1042,1257,MIRZAPUR
2010,325,132,408,1944,2426,5235,MORADABAD
2010,388,68,466,1368,2993,5283,MUZAFFARNAGAR
2010,49,32,114,215,1642,2052,PILIBHIT
2010,86,46,138,355,1253,1878,PRATAPGARH
2010,71,54,104,325,1089,1643,RAIBAREILLY
2010,63,24,166,241,1374,1868,RAMABAI NAGAR
2010,145,130,228,871,1248,2622,RAMPUR
2010,113,22,80,872,1926,3013,SAHARANPUR
2010,40,48,90,209,727,1114,SANT KABIRNAGAR
2010,192,90,204,481,1603,2570,SHAHJAHANPUR
2010,26,28,50,107,489,700,SHRAWASTI
2010,21,16,80,158,485,760,SIDHARTHNAGAR
2010,117,22,228,659,2106,3132,SITAPUR
2010,21,42,46,165,737,1011,SONBHADRA
2010,22,2,18,80,293,415,ST.RAVIDASNAGAR
2010,77,28,118,417,1095,1735,SULTANPUR
2010,100,64,162,332,1107,1765,UNNAO
2010,96,18,176,1347,1849,3486,VARANASI
2010,6,6,10,47,212,281,ALMORA
2010,2,4,4,24,125,159,BAGESHWAR
2010,1,2,4,42,170,219,CHAMOLI
2010,4,2,6,26,172,210,CHAMPAWAT
2010,81,74,142,1161,1342,2800,DEHRADUN
2010,106,56,172,1058,1662,3054,HARIDWAR
2010,43,26,58,354,627,1108,NAINITAL
2010,8,8,10,97,200,323,PAURI GARHWAL
2010,5,6,10,43,185,249,PITHORAGARH
2010,8,10,6,27,164,215,RUDRA PRAYAG
2010,5,2,4,56,157,224,TEHRI GARHWAL
2010,121,44,140,1814,1086,3205,UDHAMSINGH NAGAR
2010,5,2,6,13,145,171,UTTARKASHI
2010,468,346,876,4858,10720,17268,24 PARGANAS NORTH
2010,265,516,430,5593,11541,18345,24 PARGANAS SOUTH
2010,42,36,42,724,1384,2228,ASANSOL
2010,163,72,94,541,1665,2535,BANKURA
2010,116,88,104,851,1850,3009,BIRBHUM
2010,153,144,224,1526,3680,5727,BURDWAN
2010,207,286,372,524,2876,4265,COOCHBEHAR
2010,128,112,192,352,1573,2357,DAKSHIN DINAJPUR
2010,65,72,154,1240,1953,3484,DARJEELING
2010,171,104,174,1621,3495,5565,HOOGHLY
2010,118,118,370,3011,6131,9748,HOWRAH
2010,17,0,10,1134,188,1349,HOWRAH G.R.P.
2010,214,360,518,2726,4983,8801,JALPAIGURI
2010,1,0,6,242,104,353,KHARAGPUR G.R.P.
2010,104,64,250,6346,10253,17017,KOLKATA
2010,225,334,378,715,3196,4848,MALDA
2010,805,1052,1022,2105,9365,14349,MURSHIDABAD
2010,456,334,690,2536,6731,10747,NADIA
2010,381,134,202,1211,3305,5233,PASCHIM MIDNAPUR
2010,95,102,254,886,3578,4915,PURAB MIDNAPUR
2010,115,84,74,603,1254,2130,PURULIA
2010,23,4,12,598,206,843,SEALDAH G.R.P.
2010,8,0,6,205,120,339,SILIGURI G.R.P.
2010,169,260,236,791,2872,4328,UTTAR DINAJPUR
2010,15,46,20,317,710,1108,ANDAMAN
2010,1,2,0,13,118,134,NICOBAR
2010,51,62,76,3276,1338,4803,CHANDIGARH
2010,6,6,36,156,320,524,D and N HAVELI
2010,7,2,4,111,179,303,DAMAN
2010,0,0,0,16,130,146,DIU
2010,0,0,0,0,291,291,CAW
2010,36,40,252,2800,900,4028,CENTRAL
2010,5,0,2,16,124,147,CRIME BRANCH
2010,111,94,714,7178,2286,10383,EAST
2010,0,0,0,0,169,169,EOW
2010,17,4,46,1305,202,1574,GRP(RLY)
2010,0,0,26,171,686,883,IGI AIRPORT
2010,10,32,58,1211,732,2043,NEW DELHI
2010,46,14,322,2431,1350,4163,NORTH
2010,95,102,916,5232,1697,8042,NORTH-EAST
2010,109,100,520,5238,1676,7643,NORTH-WEST
2010,140,98,914,4539,2308,7999,OUTER
2010,56,118,480,5174,2036,7864,SOUTH
2010,73,160,738,4872,2335,8178,SOUTH-EAST
2010,83,108,726,2792,1516,5225,SOUTH-WEST
2010,3,0,2,0,111,116,STF
2010,92,144,700,5381,2008,8325,WEST
2010,0,0,0,15,136,151,LAKSHADWEEP
2010,7,2,4,115,758,886,KARAIKAL
2010,45,4,30,1042,2539,3660,PUDUCHERRY
2011,203,168,154,935,3953,5413,ADILABAD
2011,279,32,166,1565,3904,5946,ANANTAPUR
2011,146,34,168,1405,3975,5728,CHITTOOR
2011,187,82,146,1322,4058,5795,CUDDAPAH
2011,341,178,292,9332,10215,20358,CYBERABAD
2011,193,144,120,2333,5010,7800,EAST GODAVARI
2011,9,0,0,459,158,626,GUNTAKAL RLY.
2011,161,80,116,1649,5385,7391,GUNTUR
2011,81,66,62,1854,2515,4578,GUNTUR URBAN
2011,253,118,190,9573,8095,18229,HYDERABAD CITY
2011,274,116,344,1951,6508,9193,KARIMNAGAR
2011,206,168,162,1359,4409,6304,KHAMMAM
2011,148,160,178,1463,5188,7137,KRISHNA
2011,330,78,152,1378,5538,7476,KURNOOL
2011,273,176,148,2590,4513,7700,MAHABOOBNAGAR
2011,198,76,80,1484,4179,6017,MEDAK
2011,196,96,168,1539,5960,7959,NALGONDA
2011,143,56,170,2115,4485,6969,NELLORE
2011,190,126,168,1979,4563,7026,NIZAMABAD
2011,199,48,200,1244,4432,6123,PRAKASHAM
2011,77,30,72,868,1486,2533,RAJAHMUNDRY
2011,94,48,48,359,1404,1953,RANGA REDDY
2011,11,0,2,901,199,1113,SECUNDERABAD RLY.
2011,105,58,56,642,3524,4385,SRIKAKULAM
2011,74,20,42,1883,1612,3631,TIRUPATHI URBAN
2011,101,74,140,3331,4537,8183,VIJAYAWADA CITY
2011,2,2,6,804,164,978,VIJAYAWADA RLY.
2011,94,76,72,743,2673,3658,VISAKHA RURAL
2011,73,114,100,2892,2865,6044,VISAKHAPATNAM
2011,70,100,52,827,4094,5143,VIZIANAGARAM
2011,104,96,136,923,3463,4722,WARANGAL
2011,56,70,110,1012,2798,4046,WARANGAL URBAN
2011,166,194,288,2853,5475,8976,WEST GODAVARI
2011,3,0,0,9,116,128,ANJAW
2011,13,6,24,88,210,341,CHANGLANG
2011,4,6,6,40,152,208,DIBANG VALLEY
2011,3,8,0,9,120,140,K/KUMEY
2011,3,6,4,30,166,209,KAMENG EAST
2011,7,0,4,47,179,237,KAMENG WEST
2011,15,10,20,91,170,306,LOHIT
2011,13,8,46,280,401,748,PAPUM PARE
2011,3,4,10,36,160,213,RURAL
2011,4,16,8,194,196,418,SIANG EAST
2011,2,2,6,26,128,164,SIANG UPPER
2011,5,4,16,83,226,334,SIANG WEST
2011,5,4,6,40,145,200,SUBANSIRI LOWER
2011,2,4,16,26,191,239,SUBANSIRI UPPER
2011,0,0,2,15,138,155,TAWANG
2011,12,6,18,71,167,274,TIRAP
2011,0,0,0,3,105,108,UPPER DIBANG VALLEY
2011,71,184,336,660,2177,3428,BARPETA
2011,47,58,136,211,574,1026,BASKA
2011,30,144,148,396,1105,1823,BONGAIGAON
2011,0,0,2,8,130,140,C.I.D.
2011,71,148,356,1286,3215,5076,CACHAR
2011,27,60,86,218,497,888,CHIRANG
2011,37,190,400,516,1784,2927,DARRANG
2011,37,124,126,243,813,1343,DHEMAJI
2011,80,314,614,641,3022,4671,DHUBRI
2011,89,108,270,996,1616,3079,DIBRUGARH
2011,7,2,16,348,241,614,G.R.P.
2011,44,198,200,468,1732,2642,GOALPARA
2011,112,108,318,564,1327,2429,GOLAGHAT
2011,117,112,732,5445,6404,12810,GUWAHATI CITY
2011,22,122,156,324,1029,1653,HAILAKANDI
2011,57,98,170,866,1374,2565,JORHAT
2011,48,126,312,927,2014,3427,KAMRUP
2011,75,26,94,327,487,1009,KARBI ANGLONG
2011,70,92,158,441,1597,2358,KARIMGANJ
2011,78,104,210,383,802,1577,KOKRAJHAR
2011,54,104,286,419,1536,2399,LAKHIMPUR
2011,35,108,192,197,917,1449,MORIGAON
2011,18,6,38,106,207,375,N.C.HILLS
2011,161,330,748,1431,4158,6828,NAGAON
2011,30,56,190,561,1257,2094,NALBARI
2011,6,10,6,18,157,197,R.P.O.
2011,91,98,264,927,1367,2747,SIBSAGAR
2011,98,192,524,983,2528,4325,SONITPUR
2011,147,122,306,954,1333,2862,TINSUKIA
2011,48,56,134,227,723,1188,UDALGURI
2011,113,138,230,652,2258,3391,ARARIA
2011,92,10,34,200,629,965,ARWAL
2011,193,36,124,787,2477,3617,AURANGABAD
2011,83,32,124,328,1222,1789,BAGAHA
2011,106,52,132,352,1394,2036,BANKA
2011,140,34,238,809,2643,3864,BEGUSARAI
2011,86,42,236,1022,3070,4456,BETTIAH
2011,119,18,114,536,1545,2332,BHABHUA
2011,136,46,212,966,2185,3545,BHAGALPUR
2011,137,32,128,836,2792,3925,BHOJPUR
2011,99,26,152,673,1600,2550,BUXAR
2011,163,68,256,1012,3912,5411,DARBHANGA
2011,177,46,310,1798,3727,6058,GAYA
2011,246,34,278,531,2517,3606,GOPALGANJ
2011,6,0,6,389,181,582,JAMALPUR RLY.
2011,206,46,142,466,1310,2170,JAMUI
2011,61,20,62,442,1344,1929,JEHANABAD
2011,165,206,252,684,2802,4109,KATIHAR
2011,18,4,16,398,250,686,KATIHAR RLY.
2011,100,28,106,256,1655,2145,KHAGARIA
2011,39,60,126,422,897,1544,KISHANGANJ
2011,48,10,102,307,987,1454,LAKHISARAI
2011,56,16,156,387,1444,2059,MADHEPURA
2011,89,88,364,946,3858,5345,MADHUBANI
2011,877,74,418,1405,5375,8149,MOTIHARI
2011,117,14,144,549,1473,2297,MUNGER
2011,178,112,510,2594,4684,8078,MUZAFFARPUR
2011,13,0,12,554,298,877,MUZAFFARPUR RLY.
2011,145,30,162,617,3779,4733,NALANDA
2011,64,14,76,132,1247,1533,NAUGACHIA
2011,103,24,126,450,2034,2737,NAWADAH
2011,273,82,728,6526,8779,16388,PATNA
2011,26,2,12,1575,383,1998,PATNA RLY.
2011,134,124,262,462,2510,3492,PURNEA
2011,221,40,212,1473,2930,4876,ROHTAS
2011,143,16,126,350,1530,2165,SAHARSA
2011,328,80,332,836,3132,4708,SAMASTIPUR
2011,531,20,292,1216,3714,5773,SARAN
2011,41,6,44,218,880,1189,SHEIKHPURA
2011,36,8,50,138,533,765,SHEOHAR
2011,104,16,116,1091,2881,4208,SITAMARHI
2011,265,32,392,735,2514,3938,SIWAN
2011,61,46,156,519,1573,2355,SUPAUL
2011,187,36,466,1616,3169,5474,VAISHALI
2011,66,110,4,80,764,1024,BALRAMPUR
2011,155,140,48,1634,4010,5987,BILASPUR
2011,151,8,8,48,223,438,BIZAPUR
2011,123,16,18,124,529,810,DANTEWARA
2011,20,54,36,278,950,1338,DHAMTARI
2011,184,230,230,2593,8770,12007,DURG
2011,42,42,8,115,611,818,GARIYABAND
2011,4,4,0,393,172,573,GRP RAIPUR
2011,88,136,18,329,1920,2491,JAGDALPUR
2011,69,66,26,876,2593,3630,JANJGIR
2011,92,156,98,235,929,1510,JASHPUR
2011,34,46,32,252,1191,1555,KABIRDHAM
2011,77,58,16,116,812,1079,KANKER
2011,47,78,10,645,1934,2714,KORBA
2011,65,144,32,357,1258,1856,KORIYA
2011,36,60,74,517,1689,2376,MAHASAMUND
2011,63,10,4,24,191,292,NARAYANPUR
2011,138,124,30,1022,2096,3410,RAIGARH
2011,179,266,110,3739,7558,11852,RAIPUR
2011,77,76,44,526,2632,3355,RAJNANDGAON
2011,87,130,64,542,1721,2544,SARGUJA
2011,60,152,34,278,1319,1843,SURAJPUR
2011,43,26,28,1540,1090,2727,NORTH GOA
2011,27,32,28,1036,757,1880,SOUTH GOA
2011,164,120,460,9330,13712,23786,AHMEDABAD COMMR.
2011,52,20,148,821,3017,4058,AHMEDABAD RURAL
2011,9,2,0,34,297,342,AHWA-DANG
2011,29,20,158,382,1779,2368,AMRELI
2011,23,20,90,845,2614,3592,ANAND
2011,44,26,56,829,2354,3309,BHARUCH
2011,81,16,176,1075,3455,4803,BHAVNAGAR
2011,1,0,0,2,105,108,CID CRIME
2011,52,12,106,582,1504,2256,DAHOD
2011,36,28,42,1041,5080,6227,GANDHINAGAR
2011,40,20,96,604,4211,4971,HIMATNAGAR
2011,65,42,130,1151,4257,5645,JAMNAGAR
2011,44,22,138,934,3540,4678,JUNAGADH
2011,53,24,106,524,4465,5172,KHEDA NORTH
2011,46,16,48,634,2219,2963,KUTCH (EAST(G))
2011,36,30,30,538,1572,2206,KUTCH (WEST-BHUJ)
2011,43,18,142,1385,3419,5007,MEHSANA
2011,16,14,8,38,663,739,NARMADA
2011,30,4,20,357,1173,1584,NAVSARI
2011,74,76,184,1086,4343,5763,PALANPUR
2011,66,20,120,508,3088,3802,PANCHMAHAL
2011,31,32,94,684,2659,3500,PATAN
2011,19,12,24,186,791,1032,PORBANDAR
2011,66,20,80,2072,2652,4890,RAJKOT COMMR.
2011,64,46,150,682,3988,4930,RAJKOT RURAL
2011,138,72,224,4110,5723,10267,SURAT COMMR.
2011,44,12,32,711,2951,3750,SURAT RURAL
2011,47,38,88,554,2617,3344,SURENDRANAGAR
2011,15,4,4,182,674,879,TAPI
2011,48,18,100,3404,3608,7178,VADODARA COMMR.
2011,69,56,130,498,2714,3467,VADODARA RURAL
2011,46,18,38,868,2000,2970,VALSAD
2011,7,0,4,437,177,625,W.RLY AHMEDABAD
2011,6,0,2,1120,198,1326,W.RLY VADODARA
2011,75,74,68,1775,1613,3605,AMBALA
2011,116,82,86,1666,1763,3713,BHIWANI
2011,119,108,210,4277,2585,7299,FARIDABAD
2011,49,30,50,672,882,1683,FATEHABAD
2011,34,0,4,1073,768,1879,GRP
2011,146,80,98,7349,2169,9842,GURGAON
2011,150,72,166,2775,2288,5451,HISSAR
2011,102,64,62,1136,1232,2596,JHAJJAR
2011,84,74,64,1494,1192,2908,JIND
2011,59,40,46,942,1153,2240,KAITHAL
2011,94,124,44,1894,1874,4030,KARNAL
2011,50,58,68,1310,1215,2701,KURUKSHETRA
2011,55,52,92,1213,1213,2625,MAHENDRAGARH
2011,58,56,64,779,1467,2424,MEWAT
2011,98,108,108,1359,1474,3147,PALWAL
2011,31,34,34,1005,861,1965,PANCHKULA
2011,75,94,180,2130,1711,4190,PANIPAT
2011,69,34,52,1459,1444,3058,REWARI
2011,127,114,94,2136,1694,4165,ROHTAK
2011,73,42,120,1498,1352,3085,SIRSA
2011,143,54,108,1659,1717,3681,SONIPAT
2011,106,72,100,1241,1233,2752,YAMUNANAGAR
2011,11,16,34,188,473,722,BADDIPOLICEDIST
2011,10,16,6,155,1000,1187,BILASPUR
2011,17,12,38,152,568,787,CHAMBA
2011,0,0,0,0,106,106,CID
2011,0,0,0,15,120,135,G.R.P.
2011,8,10,16,99,773,906,HAMIRPUR
2011,28,64,136,565,2137,2930,KANGRA
2011,3,12,2,46,217,280,KINNAUR
2011,15,40,26,202,781,1064,KULLU
2011,0,2,0,3,203,208,LAHAUL-SPITI
2011,18,52,34,284,1385,1773,MANDI
2011,30,44,48,673,2350,3145,SHIMLA
2011,13,24,34,204,740,1015,SIRMAUR
2011,17,22,26,321,764,1150,SOLAN
2011,10,22,24,183,808,1047,UNA
2011,14,36,224,405,986,1665,ANANTNAG
2011,12,8,52,103,480,655,AWANTIPORA
2011,11,2,118,193,423,747,BANDIPORA
2011,20,24,154,273,810,1281,BARAMULLA
2011,15,16,202,527,844,1604,BUDGAM
2011,0,0,0,0,104,104,CRIME JAMMU
2011,0,0,0,0,104,104,CRIME SRINAGAR
2011,22,32,94,130,596,874,DODA
2011,8,18,64,122,425,637,GANDERBAL
2011,22,12,66,139,405,644,HANDWARA
2011,101,70,136,1498,2949,4754,JAMMU
2011,3,2,2,12,200,219,KARGIL
2011,30,34,76,217,995,1352,KATHUA
2011,18,8,50,58,414,548,KISHTWAR
2011,16,20,92,190,502,820,KULGAM
2011,32,22,92,203,581,930,KUPWARA
2011,1,6,2,19,254,282,LEH
2011,24,36,64,98,727,949,POONCH
2011,16,10,78,142,375,621,PULWAMA
2011,1,0,0,8,111,120,RAILWAYS JAMMU
2011,0,0,0,20,119,139,RAILWAYS KASHMIR
2011,48,64,86,174,1616,1988,RAJOURI
2011,11,26,32,97,743,909,RAMBAN
2011,21,22,34,88,553,718,REASI
2011,26,6,22,105,719,878,SAMBA
2011,36,16,58,350,369,829,SHOPIAN
2011,56,8,84,305,304,757,SOPORE
2011,76,28,236,1295,1533,3168,SRINAGAR
2011,23,28,36,157,959,1203,UDHAMPUR
2011,81,92,114,1626,1876,3789,BOKARO
2011,158,64,28,294,543,1087,CHAIBASA
2011,65,24,44,258,743,1134,CHATRA
2011,114,68,48,682,961,1873,DEOGHAR
2011,97,64,198,1966,2283,4608,DHANBAD
2011,4,0,6,425,251,686,DHANBAD RLY.
2011,88,68,56,659,1085,1956,DUMKA
2011,131,102,66,209,1471,1979,GARHWA
2011,68,94,126,941,1671,2900,GIRIDIH
2011,61,58,76,238,1033,1466,GODDA
2011,253,92,104,277,553,1279,GUMLA
2011,113,44,116,742,1649,2664,HAZARIBAGH
2011,114,78,146,1864,1768,3970,JAMSHEDPUR
2011,8,2,16,315,165,506,JAMSHEDPUR RLY.
2011,34,30,22,211,586,883,JAMTARA
2011,147,26,26,120,239,558,KHUNTI
2011,65,14,48,323,818,1268,KODERMA
2011,67,54,54,167,379,721,LATEHAR
2011,42,60,52,274,436,864,LOHARDAGGA
2011,31,78,38,242,582,971,PAKUR
2011,165,56,126,648,1415,2410,PALAMU
2011,55,48,62,572,605,1342,RAMGARH
2011,189,100,132,1058,1337,2816,RANCHI
2011,112,142,108,245,779,1386,SAHEBGANJ
2011,107,60,32,477,528,1204,SARAIKELA
2011,96,50,38,121,260,565,SIMDEGA
2011,76,30,30,405,1876,2417,BAGALKOT
2011,692,194,1146,23567,12441,38040,BANGALORE COMMR.
2011,144,58,60,1643,3598,5503,BANGALORE RURAL
2011,257,90,106,1374,5731,7558,BELGAUM
2011,115,12,42,930,2425,3524,BELLARY
2011,84,28,26,408,3105,3651,BIDAR
2011,124,14,86,431,2507,3162,BIJAPUR
2011,93,32,46,922,1895,2988,CBPURA
2011,68,22,14,358,1675,2137,CHAMARAJNAGAR
2011,61,20,34,525,2302,2942,CHICKMAGALUR
2011,59,54,60,803,3591,4567,CHITRADURGA
2011,43,12,12,332,1476,1875,DAKSHIN KANNADA
2011,53,22,34,557,2289,2955,DAVANAGERE
2011,49,14,46,751,1247,2107,DHARWAD COMMR.
2011,50,0,14,191,1167,1422,DHARWAD RURAL
2011,42,10,20,201,944,1217,GADAG
2011,207,72,170,1112,3348,4909,GULBARGA
2011,143,54,54,1218,4936,6405,HASSAN
2011,50,26,44,297,2045,2462,HAVERI
2011,33,8,24,240,824,1129,K.G.F.
2011,58,32,22,358,1617,2087,KODAGU
2011,82,34,36,527,1672,2351,KOLAR
2011,40,26,42,361,1580,2049,KOPPAL
2011,128,62,68,1543,4850,6651,MANDYA
2011,42,32,16,619,2110,2819,MANGALORE CITY
2011,65,22,50,1936,1717,3790,MYSORE COMMR.
2011,117,38,94,966,3434,4649,MYSORE RURAL
2011,85,58,74,410,2906,3533,RAICHUR
2011,17,0,2,1079,195,1293,RAILWAYS
2011,129,38,104,1195,3273,4739,RAMANAGAR
2011,130,46,50,912,4592,5730,SHIMOGA
2011,195,62,80,1375,4250,5962,TUMKUR
2011,31,10,18,540,2143,2742,UDUPI
2011,49,22,14,248,2717,3050,UTTAR KANNADA
2011,46,18,52,206,1373,1695,YADGIRI
2011,42,112,30,730,8859,9773,ALAPUZHA
2011,51,124,22,751,12348,13296,ERNAKULAM COMMR.
2011,29,60,24,769,33451,34333,ERNAKULAM RURAL
2011,51,108,20,508,5538,6225,IDUKKI
2011,65,110,28,839,7013,8055,KANNUR
2011,40,250,30,419,3246,3985,KASARGOD
2011,55,102,42,600,5664,6463,KOLLAM COMMR.
2011,54,92,26,536,5771,6479,KOLLAM RURAL
2011,72,102,48,756,7446,8424,KOTTAYAM
2011,20,28,22,696,3255,4021,KOZHIKODE COMMR.
2011,43,92,42,478,6732,7387,KOZHIKODE RURAL
2011,30,166,48,1079,11629,12952,MALAPPURAM
2011,84,170,26,740,6736,7756,PALAKKAD
2011,39,66,34,532,4873,5544,PATHANAMTHITTA
2011,2,0,0,511,177,690,RAILWAYS
2011,25,56,24,408,3874,4387,THRISSUR COMMR.
2011,65,138,24,729,10196,11152,THRISSUR RURAL
2011,37,78,50,1127,5190,6482,TRIVANDRUM COMMR.
2011,68,280,42,1008,7948,9346,TRIVANDRUM RURAL
2011,14,130,16,250,3836,4246,WAYANADU
2011,115,48,38,149,1090,1440,ALIRAJPUR
2011,62,120,14,271,1148,1615,ANUPPUR
2011,47,72,14,323,2302,2758,ASHOK NAGAR
2011,72,110,14,281,2086,2563,BALAGHAT
2011,70,78,16,366,1608,2138,BARWANI
2011,83,240,38,502,2631,3494,BETUL
2011,165,102,44,656,3017,3984,BHIND
2011,203,292,80,6502,10703,17780,BHOPAL
2011,9,0,0,2337,344,2690,BHOPAL RLY.
2011,23,58,4,213,999,1297,BURHANPUR
2011,136,154,88,938,4069,5385,CHHATARPUR
2011,97,222,48,767,4317,5451,CHHINDWARA
2011,101,104,42,462,3042,3751,DAMOH
2011,96,50,38,443,2197,2824,DATIYA
2011,112,204,52,1578,4179,6125,DEWAS
2011,144,206,86,1220,4373,6029,DHAR
2011,26,92,12,88,921,1139,DINDORI
2011,88,150,52,792,2974,4056,GUNA
2011,255,150,180,5385,7042,13012,GWALIOR
2011,41,106,30,261,1065,1503,HARDA
2011,109,118,56,804,3237,4324,HOSHANGABAD
2011,272,258,132,8494,12724,21880,INDORE
2011,5,4,2,528,167,706,INDORE RLY.
2011,222,214,78,2065,8310,10889,JABALPUR
2011,6,6,4,925,225,1166,JABALPUR RLY.
2011,32,84,70,276,1746,2208,JHABUA
2011,67,124,16,445,2704,3356,KATNI
2011,66,118,26,659,2294,3163,KHANDWA
2011,63,78,26,914,3175,4256,KHARGON
2011,50,126,18,200,1923,2317,MANDLA
2011,89,98,52,834,2767,3840,MANDSAUR
2011,156,80,56,1093,4233,5618,MORENA
2011,79,130,36,423,2466,3134,NARSINGHPUR
2011,33,50,34,583,1612,2312,NEEMUCH
2011,51,96,20,305,1938,2410,PANNA
2011,117,236,72,689,3374,4488,RAISEN
2011,77,180,52,868,3799,4976,RAJGARH
2011,84,194,96,856,2991,4221,RATLAM
2011,87,182,52,1280,3823,5424,REWA
2011,190,262,212,1422,7228,9314,SAGAR
2011,101,166,40,1315,4294,5916,SATNA
2011,54,122,24,404,2284,2888,SEONI
2011,66,160,44,571,2587,3428,SHAHDOL
2011,85,100,26,943,2355,3509,SHAJAPUR
2011,25,36,22,151,1184,1418,SHEOPUR
2011,108,186,54,719,4111,5178,SHIVPURI
2011,38,64,64,408,2144,2718,SIDHI
2011,102,164,52,900,3491,4709,SIHORE
2011,56,86,50,292,1798,2282,SINGRAULI
2011,64,152,46,467,2666,3395,TIKAMGARH
2011,217,162,86,2713,6319,9497,UJJAIN
2011,32,44,8,204,1210,1498,UMARIYA
2011,103,174,60,961,3678,4976,VIDISHA
2011,215,156,164,4115,4416,9066,AHMEDNAGAR
2011,89,60,80,1964,2591,4784,AKOLA
2011,57,44,40,2323,1478,3942,AMRAVATI COMMR.
2011,96,138,58,1826,2894,5012,AMRAVATI RURAL
2011,159,32,70,2264,1982,4507,AURANGABAD COMMR.
2011,108,36,32,1258,2283,3717,AURANGABAD RURAL
2011,133,64,116,1460,2830,4603,BEED
2011,48,46,24,1083,1375,2576,BHANDARA
2011,101,52,56,1435,2754,4398,BULDHANA
2011,89,112,60,1619,2607,4487,CHANDRAPUR
2011,80,32,54,1161,1844,3171,DHULE
2011,109,40,10,271,721,1151,GADCHIROLI
2011,59,62,48,923,1254,2346,GONDIA
2011,72,36,24,428,1370,1930,HINGOLI
2011,153,96,114,2343,3438,6144,JALGAON
2011,87,30,40,1274,2024,3455,JALNA
2011,106,84,76,2196,2336,4798,KOLHAPUR
2011,116,34,74,1128,2429,3781,LATUR
2011,383,442,442,29252,12601,43120,MUMBAI COMMR.
2011,14,6,18,4336,282,4656,MUMBAI RLY.
2011,188,90,80,5529,4209,10096,NAGPUR COMMR.
2011,6,2,0,2157,219,2384,NAGPUR RLY.
2011,96,88,50,1999,2548,4781,NAGPUR RURAL
2011,166,64,104,1463,3712,5509,NANDED
2011,59,40,36,454,1131,1720,NANDURBAR
2011,69,50,32,4894,1438,6483,NASIK COMMR.
2011,145,86,66,1624,3591,5512,NASIK RURAL
2011,92,76,64,4894,2089,7215,NAVI MUMBAI
2011,77,60,56,960,2189,3342,OSMANABAD
2011,122,52,72,1131,1963,3340,PARBHANI
2011,228,158,208,11211,4829,16634,PUNE COMMR.
2011,3,0,6,797,143,949,PUNE RLY.
2011,245,174,128,4499,4404,9450,PUNE RURAL
2011,55,14,14,801,1360,2244,RAIGAD
2011,27,60,24,615,982,1708,RATNAGIRI
2011,82,80,44,1298,1662,3166,SANGLI
2011,95,68,82,2398,2462,5105,SATARA
2011,19,22,20,276,578,915,SINDHUDURG
2011,53,44,58,1349,981,2485,SOLAPUR COMMR.
2011,154,106,86,1857,3189,5392,SOLAPUR RURAL
2011,192,158,184,7361,3842,11737,THANE COMMR.
2011,208,126,110,3443,2970,6857,THANE RURAL
2011,70,68,52,1657,2337,4184,WARDHA
2011,67,26,54,1009,1567,2723,WASHIM
2011,131,88,108,2189,3391,5907,YAVATMAL
2011,29,4,36,98,283,450,BISHNUPUR
2011,10,2,0,23,138,173,CHANDEL
2011,8,0,14,40,130,192,CHURACHANDPUR
2011,0,0,0,0,105,105,CID
2011,54,22,72,212,340,700,IMPHAL EAST
2011,142,34,122,1047,641,1986,IMPHAL WEST
2011,14,0,10,51,206,281,SENAPATI
2011,4,0,0,9,141,154,TAMENGLONG
2011,47,42,78,148,453,768,THOUBAL
2011,15,2,6,24,133,180,UKHRUL
2011,30,6,24,145,201,406,GARO HILLS EAST
2011,16,4,12,83,147,262,GARO HILLS SOUTH
2011,29,16,50,355,319,769,GARO HILLS WEST
2011,56,86,24,188,272,626,JAINTIA HILLS
2011,41,84,40,616,418,1199,KHASI HILLS EAST
2011,23,30,16,129,232,430,KHASI HILLS WEST
2011,26,34,8,133,205,406,RI-BHOI
2011,20,70,2,984,338,1414,AIZAWL
2011,8,20,0,209,138,375,CHAMPHAI
2011,7,14,4,132,152,309,KOLASIB
2011,2,4,2,65,124,197,LAWNGTLAI
2011,5,26,4,223,129,387,LUNGLEI
2011,4,8,0,74,132,218,MAMIT
2011,3,4,0,65,131,203,SAIHA
2011,1,8,0,59,132,200,SERCHHIP
2011,25,18,48,416,267,774,DIMAPUR
2011,0,0,0,0,117,117,KIPHIRE
2011,13,0,0,173,178,364,KOHIMA
2011,2,2,2,22,105,133,LONGLENG
2011,3,4,4,45,126,182,MOKOKCHUNG
2011,9,4,0,20,123,156,MON
2011,5,0,0,11,114,130,PEREN
2011,12,6,0,23,120,161,PHEK
2011,3,4,8,37,113,165,TUENSANG
2011,9,2,4,51,127,193,WOKHA
2011,8,6,2,61,125,202,ZUNHEBOTO
2011,118,126,88,1204,2170,3706,ANGUL
2011,128,150,222,1101,2513,4114,BALASORE
2011,133,42,32,575,1197,1979,BARAGARH
2011,125,26,40,686,960,1837,BERHAMPUR
2011,70,52,110,416,1891,2539,BHADRAK
2011,143,104,48,515,1261,2071,BOLANGIR
2011,24,28,38,137,402,629,BOUDH
2011,77,68,92,586,1977,2800,CUTTACK
2011,97,70,80,2689,2316,5252,DCP BBSR
2011,48,38,62,1193,1503,2844,DCP CTC
2011,37,30,18,73,384,542,DEOGARH
2011,117,34,64,793,968,1976,DHENKANAL
2011,20,22,12,72,313,439,GAJAPATI
2011,287,100,102,611,1060,2160,GANJAM
2011,59,62,94,561,1159,1935,JAGATSINGHPUR
2011,81,62,98,888,1745,2874,JAJPUR
2011,57,54,28,694,774,1607,JHARSUGUDA
2011,72,92,46,270,1190,1670,KALAHANDI
2011,46,64,50,215,641,1016,KANDHAMAL
2011,71,82,88,435,1375,2051,KENDRAPARA
2011,191,150,96,794,1265,2496,KEONJHAR
2011,41,58,60,475,1262,1896,KHURDA
2011,88,106,80,393,962,1629,KORAPUT
2011,67,16,20,175,334,612,MALKANGIR
2011,176,152,178,641,1642,2789,MAYURBHANJ
2011,77,50,60,386,894,1467,NAYAGARH
2011,64,88,88,191,761,1192,NOWRANGPUR
2011,19,8,24,170,664,885,NUAPADA
2011,114,42,74,1001,2151,3382,PURI
2011,83,64,72,312,624,1155,RAYAGADA
2011,111,52,44,942,966,2115,ROURKELA
2011,91,60,26,1127,1797,3101,SAMBALPUR
2011,41,20,8,176,516,761,SONEPUR
2011,7,0,6,1013,205,1231,SRP(CUTTACK)
2011,13,2,0,613,242,870,SRP(ROURKELA)
2011,105,50,30,440,850,1475,SUNDARGARH
2011,93,32,42,271,794,1232,AMRITSAR
2011,35,10,14,243,672,974,BARNALA
2011,56,26,32,240,605,959,BATALA
2011,102,74,62,716,938,1892,BHATINDA
2011,107,40,86,925,922,2080,CP AMRITSAR
2011,68,30,90,1149,997,2334,CP JALANDHAR
2011,159,96,188,1215,1776,3434,CP LUDHIANA
2011,35,16,14,198,625,888,FARIDKOT
2011,25,8,18,256,629,936,FATEHGARH SAHIB
2011,43,42,50,261,597,993,FAZILKA
2011,76,40,64,383,779,1342,FEROZPUR
2011,9,0,2,105,388,504,G.R.P
2011,51,24,52,157,572,856,GURDASPUR
2011,94,56,62,598,1007,1817,HOSHIARPUR
2011,92,62,64,582,987,1787,JALANDHAR
2011,72,32,40,425,734,1303,KAPURTHALA
2011,45,14,24,301,635,1019,KHANNA
2011,46,16,30,241,645,978,LUDHIANA
2011,54,28,18,145,445,690,MANSA
2011,92,24,52,619,752,1539,MOGA
2011,45,34,32,239,529,879,MUKTSAR
2011,21,20,30,121,479,671,PATHANKOT
2011,90,50,62,744,1836,2782,PATIALA
2011,36,28,50,370,818,1302,ROPAR
2011,90,60,50,572,1308,2080,SANGRUR
2011,69,48,78,849,1196,2240,SAS NGR
2011,39,16,18,290,530,893,SBS NAGAR
2011,95,32,38,248,676,1089,TARN TARAN
2011,91,140,246,1439,4486,6402,AJMER
2011,155,198,322,3857,7146,11678,ALWAR
2011,48,110,204,309,2069,2740,BANSWARA
2011,62,120,182,647,2545,3556,BARAN
2011,56,42,68,555,2717,3438,BARMER
2011,178,138,386,3047,6355,10104,BHARATPUR
2011,64,104,170,1502,3194,5034,BHILWARA
2011,86,110,62,717,2739,3714,BIKANER
2011,66,80,220,528,2485,3379,BUNDI
2011,64,100,232,1030,3081,4507,CHITTORGARH
2011,86,74,66,503,2309,3038,CHURU
2011,42,26,196,1917,3741,5922,DAUSA
2011,122,64,152,901,2925,4164,DHOLPUR
2011,35,78,178,165,1694,2150,DUNGARPUR
2011,12,4,12,1006,228,1262,G.R.P.AJMER
2011,5,0,4,171,158,338,G.R.P.JODHPUR
2011,132,198,152,916,3629,5027,GANGANAGAR
2011,101,164,92,433,2825,3615,HANUMANGARH
2011,59,62,156,4812,2997,8086,JAIPUR EAST
2011,35,40,86,1421,1813,3395,JAIPUR NORTH
2011,77,74,176,1301,3794,5422,JAIPUR RURAL
2011,25,36,106,2367,2169,4703,JAIPUR SOUTH
2011,46,46,176,2278,2674,5220,JAIPUR WEST
2011,19,8,14,298,875,1214,JAISALMER
2011,49,44,100,408,1982,2583,JALORE
2011,97,134,140,819,2622,3812,JHALAWAR
2011,76,102,158,739,2958,4033,JHUNJHUNU
2011,83,66,116,2081,2299,4645,JODHPUR CITY
2011,30,52,76,349,2081,2588,JODHPUR RURAL
2011,76,76,216,1294,3405,5067,KARAULI
2011,135,48,182,1870,2444,4679,KOTA CITY
2011,83,88,118,338,1797,2424,KOTA RURAL
2011,106,140,136,911,3042,4335,NAGAUR
2011,111,128,212,776,4096,5323,PALI
2011,70,206,158,315,1702,2451,PRATAPGARH
2011,41,28,104,363,1730,2266,RAJSAMAND
2011,61,48,178,1137,2732,4156,SAWAI MADHOPUR
2011,81,100,182,1256,3750,5369,SIKAR
2011,47,54,120,277,1421,1919,SIROHI
2011,42,50,158,624,2563,3437,TONK
2011,173,220,396,1858,5362,8009,UDAIPUR
2011,11,14,10,110,228,373,EAST
2011,1,0,0,21,135,157,NORTH
2011,5,8,8,67,217,305,SOUTH
2011,4,10,2,11,181,208,WEST
2011,51,32,38,235,1767,2123,ARIYALUR
2011,500,152,112,6720,16101,23585,CHENNAI
2011,11,0,2,460,351,824,CHENNAI RLY.
2011,70,10,96,1086,3784,5046,COIMBATORE RURAL
2011,67,18,54,1801,2845,4785,COIMBATORE URBAN
2011,269,60,204,846,8362,9741,CUDDALORE
2011,83,28,140,422,3161,3834,DHARMAPURI
2011,146,36,100,662,4750,5694,DINDIGUL
2011,77,20,84,984,5467,6632,ERODE
2011,172,38,44,670,5676,6600,KANCHIPURAM
2011,114,20,100,833,4427,5494,KANYAKUMARI
2011,59,16,120,460,2211,2866,KARUR
2011,115,24,128,758,3833,4858,KRISHNAGIRI
2011,211,42,188,1085,4932,6458,MADURAI RURAL
2011,91,14,50,1102,1992,3249,MADURAI URBAN
2011,85,26,68,415,3820,4414,NAGAPATTINAM
2011,69,16,126,469,4056,4736,NAMAKKAL
2011,32,12,14,194,1231,1483,NILGIRIS
2011,34,14,50,230,1362,1690,PERAMBALUR
2011,105,14,86,452,3149,3806,PUDUKOTTAI
2011,102,12,106,503,3076,3799,RAMNATHAPURAM
2011,144,70,216,533,5508,6471,SALEM RURAL
2011,54,46,76,664,2953,3793,SALEM URBAN
2011,70,10,70,513,2648,3311,SIVAGANGAI
2011,158,20,92,1517,5365,7152,THANJAVUR
2011,147,44,176,682,4213,5262,THENI
2011,290,104,112,970,6781,8257,THIRUNELVELI RURAL
2011,75,14,34,257,991,1371,THIRUNELVELI URBAN
2011,68,12,20,345,3186,3631,THIRUVALLUR
2011,94,48,150,457,3860,4609,THIRUVANNAMALAI
2011,62,8,42,365,4151,4628,THIRUVARUR
2011,288,58,84,1100,4286,5816,THOOTHUGUDI
2011,71,18,122,2036,5212,7459,TIRUPPUR
2011,6,0,0,212,217,435,TRICHY RLY.
2011,126,26,118,650,4214,5134,TRICHY RURAL
2011,48,12,56,959,2921,3996,TRICHY URBAN
2011,149,50,168,1332,6625,8324,VELLORE
2011,412,172,412,1240,9103,11339,VILLUPURAM
2011,114,38,110,655,4293,5210,VIRUDHUNAGAR
2011,37,42,32,96,357,564,DHALAI
2011,1,0,0,6,110,117,GRP
2011,40,80,62,189,667,1038,NORTH
2011,67,116,68,336,1384,1971,SOUTH
2011,93,172,146,649,1979,3039,WEST
2011,363,152,790,7998,4499,13802,AGRA
2011,342,132,640,2798,3025,6937,ALIGARH
2011,282,134,440,3135,3550,7541,ALLAHABAD
2011,81,32,160,295,903,1471,AMBEDKAR NAGAR
2011,49,30,152,296,897,1424,AURAIYA
2011,95,56,240,568,1479,2438,AZAMGARH
2011,221,36,274,400,1864,2795,BADAUN
2011,153,24,176,654,1030,2037,BAGHPAT
2011,108,114,266,560,1855,2903,BAHRAICH
2011,86,14,132,344,776,1352,BALLIA
2011,28,20,100,134,471,753,BALRAMPUR
2011,67,52,96,305,914,1434,BANDA
2011,123,72,284,475,1514,2468,BARABANKI
2011,266,68,410,1406,3279,5429,BAREILLY
2011,31,14,58,114,716,933,BASTI
2011,162,68,228,528,1098,2084,BHIM NAGAR
2011,122,78,256,580,1785,2821,BIJNOR
2011,337,94,436,1191,2329,4387,BULANDSHAHAR
2011,32,16,40,197,793,1078,CHANDOLI
2011,30,40,50,204,424,748,CHITRAKOOT DHAM
2011,66,40,198,260,848,1412,CSM NAGAR
2011,51,16,116,260,911,1354,DEORIA
2011,137,38,138,429,1214,1956,ETAH
2011,103,26,162,465,1611,2367,ETAWAH
2011,80,54,238,573,1387,2332,FAIZABAD
2011,106,32,182,361,731,1412,FATEHGARH
2011,96,80,212,357,1653,2398,FATEHPUR
2011,200,64,348,903,1906,3421,FIROZABAD
2011,44,4,26,6337,1767,8178,G.R.P.
2011,194,50,282,6355,2105,8986,GAUTAMBUDH NAGAR
2011,298,44,514,6571,3195,10622,GHAZIABAD
2011,75,22,42,257,527,923,GHAZIPUR
2011,97,68,258,548,1556,2527,GONDA
2011,205,100,464,2616,2673,6058,GORAKHPUR
2011,54,24,76,158,455,767,HAMIRPUR
2011,112,48,260,437,2482,3339,HARDOI
2011,110,70,186,519,1008,1893,HATHRAS
2011,102,88,122,454,970,1736,J.P.NAGAR
2011,60,14,98,262,817,1251,JALAUN
2011,88,28,186,349,1217,1868,JAUNPUR
2011,95,38,194,922,1119,2368,JHANSI
2011,78,28,214,240,1637,2197,KANNAUJ
2011,299,142,686,3939,3952,9018,KANPUR NAGAR
2011,89,44,124,222,686,1165,KANSHIRAM NAGAR
2011,71,46,106,341,1008,1572,KAUSHAMBI
2011,182,70,280,664,2011,3207,KHIRI
2011,74,26,152,257,1168,1677,KUSHI NAGAR
2011,30,30,74,150,649,933,LALITPUR
2011,216,110,584,4860,6016,11786,LUCKNOW
2011,32,36,86,125,626,905,MAHARAJGANJ
2011,32,32,66,183,438,751,MAHOBA
2011,156,66,222,658,1444,2546,MAINPURI
2011,238,78,290,1631,2890,5127,MATHURA
2011,98,38,132,431,812,1511,MAU
2011,424,158,646,5382,3284,9894,MEERUT
2011,31,6,10,152,892,1091,MIRZAPUR
2011,192,110,366,1990,1882,4540,MORADABAD
2011,292,38,476,1153,2605,4564,MUZAFFARNAGAR
2011,133,36,200,826,1239,2434,PANCHSHIL NAGAR
2011,78,24,138,235,2207,2682,PILIBHIT
2011,122,22,132,496,798,1570,PRABUDDH NAGAR
2011,114,48,180,402,1331,2075,PRATAPGARH
2011,64,58,120,314,1199,1755,RAIBAREILLY
2011,77,42,180,281,1576,2156,RAMABAI NAGAR
2011,170,86,242,948,1418,2864,RAMPUR
2011,156,42,180,957,2118,3453,SAHARANPUR
2011,35,34,96,130,649,944,SANT KABIRNAGAR
2011,195,80,282,586,1798,2941,SHAHJAHANPUR
2011,31,32,80,135,433,711,SHRAWASTI
2011,20,18,84,156,546,824,SIDHARTHNAGAR
2011,170,132,464,828,2241,3835,SITAPUR
2011,29,38,52,201,665,985,SONBHADRA
2011,17,4,14,114,310,459,ST.RAVIDASNAGAR
2011,98,42,104,472,1087,1803,SULTANPUR
2011,109,72,224,436,1530,2371,UNNAO
2011,101,22,184,1227,1810,3344,VARANASI
2011,2,6,4,37,171,220,ALMORA
2011,1,4,4,8,136,153,BAGESHWAR
2011,6,4,2,35,142,189,CHAMOLI
2011,8,8,6,34,154,210,CHAMPAWAT
2011,60,62,110,1084,1091,2407,DEHRADUN
2011,114,52,190,1443,1463,3262,HARIDWAR
2011,31,20,48,352,560,1011,NAINITAL
2011,7,2,10,107,209,335,PAURI GARHWAL
2011,8,18,8,34,200,268,PITHORAGARH
2011,8,6,8,25,150,197,RUDRA PRAYAG
2011,5,6,2,22,164,199,TEHRI GARHWAL
2011,114,62,232,1521,1293,3222,UDHAMSINGH NAGAR
2011,3,8,4,19,151,185,UTTARKASHI
2011,447,406,1174,6162,11992,20181,24 PARGANAS NORTH
2011,250,548,698,4730,11713,17939,24 PARGANAS SOUTH
2011,61,62,128,1393,2450,4094,ASANSOL
2011,112,88,84,609,1711,2604,BANKURA
2011,176,88,116,790,1748,2918,BIRBHUM
2011,109,104,202,1059,3080,4554,BURDWAN
2011,165,266,388,589,2485,3893,COOCHBEHAR
2011,134,110,242,423,1761,2670,DAKSHIN DINAJPUR
2011,57,98,176,1285,2619,4235,DARJEELING
2011,143,108,260,1744,3890,6145,HOOGHLY
2011,77,70,258,1331,4332,6068,HOWRAH
2011,38,48,220,2362,3133,5801,HOWRAH CITY
2011,15,2,16,1055,196,1284,HOWRAH G.R.P.
2011,187,422,586,3138,5240,9573,JALPAIGURI
2011,4,0,4,351,136,495,KHARAGPUR G.R.P.
2011,139,92,296,7206,11009,18742,KOLKATA
2011,206,358,486,878,3393,5321,MALDA
2011,782,866,1132,2378,10274,15432,MURSHIDABAD
2011,511,370,1000,2874,9134,13889,NADIA
2011,282,106,282,1531,4044,6245,PASCHIM MIDNAPUR
2011,97,130,350,863,3762,5202,PURAB MIDNAPUR
2011,93,130,104,596,1329,2252,PURULIA
2011,19,2,16,766,203,1006,SEALDAH G.R.P.
2011,3,0,8,300,174,485,SILIGURI G.R.P.
2011,244,252,344,869,2870,4579,UTTAR DINAJPUR
2011,19,26,30,270,594,939,ANDAMAN
2011,1,0,0,7,118,126,NICOBAR
2011,64,54,116,3365,1327,4926,CHANDIGARH
2011,16,8,18,169,317,528,D and N HAVELI
2011,7,2,4,106,186,305,DAMAN
2011,0,0,2,29,134,165,DIU
2011,0,2,0,0,232,234,CAW
2011,40,32,308,2681,766,3827,CENTRAL
2011,5,2,0,6,139,152,CRIME BRANCH
2011,107,110,786,7209,2536,10748,EAST
2011,0,0,0,0,104,104,EOW
2011,13,8,50,1520,229,1820,GRP(RLY)
2011,1,0,6,134,151,292,IGI AIRPORT
2011,10,4,66,887,603,1570,NEW DELHI
2011,57,22,354,2451,1222,4106,NORTH
2011,109,138,1060,5545,2072,8924,NORTH-EAST
2011,87,116,662,4809,1743,7417,NORTH-WEST
2011,144,146,1154,4782,2588,8814,OUTER
2011,55,130,444,4744,2109,7482,SOUTH
2011,94,150,956,5082,2735,9017,SOUTH-EAST
2011,95,138,782,2679,1638,5332,SOUTH-WEST
2011,3,0,0,0,111,114,STF
2011,109,146,906,5308,2282,8751,WEST
2011,1,0,0,8,142,151,LAKSHADWEEP
2011,2,0,2,95,783,882,KARAIKAL
2011,52,14,22,1410,2806,4304,PUDUCHERRY
2012,161,176,164,1002,4509,6012,ADILABAD
2012,296,36,148,1394,3966,5840,ANANTAPUR
2012,166,56,112,1151,3348,4833,CHITTOOR
2012,214,52,152,1175,4609,6202,CUDDAPAH
2012,311,150,316,10123,9754,20654,CYBERABAD
2012,164,142,108,2084,5000,7498,EAST GODAVARI
2012,7,2,2,540,160,711,GUNTAKAL RLY.
2012,164,46,126,1568,5826,7730,GUNTUR
2012,109,48,84,1994,3129,5364,GUNTUR URBAN
2012,268,148,176,8104,8903,17599,HYDERABAD CITY
2012,240,80,282,2075,6481,9158,KARIMNAGAR
2012,240,156,146,1359,4410,6311,KHAMMAM
2012,131,134,134,1620,5489,7508,KRISHNA
2012,254,44,116,1303,4995,6712,KURNOOL
2012,272,112,152,2176,4588,7300,MAHABOOBNAGAR
2012,156,52,108,1818,4351,6485,MEDAK
2012,174,104,178,1956,6873,9285,NALGONDA
2012,180,46,180,2005,5012,7423,NELLORE
2012,161,70,76,1590,3993,5890,NIZAMABAD
2012,225,74,168,1635,4824,6926,PRAKASHAM
2012,48,26,18,801,1516,2409,RAJAHMUNDRY
2012,99,54,44,514,1564,2275,RANGA REDDY
2012,4,4,0,1577,215,1800,SECUNDERABAD RLY.
2012,75,78,36,480,3251,3920,SRIKAKULAM
2012,66,24,50,1461,1577,3178,TIRUPATHI URBAN
2012,98,94,132,3052,5144,8520,VIJAYAWADA CITY
2012,8,0,6,1201,216,1431,VIJAYAWADA RLY.
2012,96,54,44,571,2174,2939,VISAKHA RURAL
2012,71,100,54,2531,2769,5525,VISAKHAPATNAM
2012,80,88,42,694,3778,4682,VIZIANAGARAM
2012,122,112,132,1063,3578,5007,WARANGAL
2012,58,60,82,1051,2572,3823,WARANGAL URBAN
2012,182,260,172,2524,5305,8443,WEST GODAVARI
2012,0,0,2,7,112,121,ANJAW
2012,13,12,24,90,222,361,CHANGLANG
2012,4,4,10,44,140,202,DIBANG VALLEY
2012,1,4,2,11,119,137,K/KUMEY
2012,10,12,4,32,191,249,KAMENG EAST
2012,7,0,6,41,175,229,KAMENG WEST
2012,15,6,24,112,204,361,LOHIT
2012,9,14,40,253,361,677,PAPUM PARE
2012,7,12,8,32,151,210,RURAL
2012,5,12,2,116,185,320,SIANG EAST
2012,2,2,6,29,126,165,SIANG UPPER
2012,5,4,8,102,232,351,SIANG WEST
2012,5,0,8,44,185,242,SUBANSIRI LOWER
2012,3,8,8,47,219,285,SUBANSIRI UPPER
2012,2,0,0,41,120,163,TAWANG
2012,13,2,12,96,198,321,TIRAP
2012,1,0,0,7,108,116,UPPER DIBANG VALLEY
2012,45,66,124,249,459,943,BAKSA
2012,55,196,450,653,3736,5090,BARPETA
2012,0,0,0,0,104,104,BIEO
2012,26,100,146,372,1050,1694,BONGAIGAON
2012,1,8,4,10,154,177,C.I.D.
2012,72,188,350,1436,3421,5467,CACHAR
2012,44,48,80,196,552,920,CHIRANG
2012,39,176,382,505,1622,2724,DARRANG
2012,34,148,174,262,793,1411,DHEMAJI
2012,111,318,630,730,3192,4981,DHUBRI
2012,114,100,268,1270,1852,3604,DIBRUGARH
2012,15,6,8,336,352,717,G.R.P.
2012,99,130,168,774,1634,2805,GOALPARA
2012,92,120,362,626,1482,2682,GOLAGHAT
2012,89,156,682,5957,4199,11083,GUWAHATI CITY
2012,37,112,192,348,932,1621,HAILAKANDI
2012,9,6,32,94,156,297,HAMREN
2012,72,84,212,1038,1678,3084,JORHAT
2012,59,108,242,883,4188,5480,KAMRUP
2012,59,56,116,397,533,1161,KARBI ANGLONG
2012,58,64,170,540,1732,2564,KARIMGANJ
2012,152,54,180,527,5897,6810,KOKRAJHAR
2012,47,124,256,494,1465,2386,LAKHIMPUR
2012,53,116,176,273,1086,1704,MORIGAON
2012,28,10,46,86,223,393,N.C.HILLS
2012,160,346,702,1549,3934,6691,NAGAON
2012,25,68,202,496,1261,2052,NALBARI
2012,2,0,16,14,184,216,R.P.O.
2012,131,156,336,1036,1546,3205,SIBSAGAR
2012,132,194,482,1196,2731,4735,SONITPUR
2012,118,128,320,1186,1466,3218,TINSUKIA
2012,60,46,116,260,552,1034,UDALGURI
2012,188,106,244,504,1910,2952,ARARIA
2012,92,10,52,156,711,1021,ARWAL
2012,281,44,142,810,2388,3665,AURANGABAD
2012,43,22,152,310,1454,1981,BAGAHA
2012,111,34,104,357,1441,2047,BANKA
2012,381,22,286,1024,2620,4333,BEGUSARAI
2012,233,70,332,1474,3734,5843,BETTIAH
2012,91,20,90,549,1444,2194,BHABHUA
2012,176,62,264,924,2178,3604,BHAGALPUR
2012,192,18,148,840,3084,4282,BHOJPUR
2012,166,42,178,768,1750,2904,BUXAR
2012,485,88,414,1066,4730,6783,DARBHANGA
2012,192,70,308,1610,4685,6865,GAYA
2012,140,40,270,649,3209,4308,GOPALGANJ
2012,17,2,4,383,151,557,JAMALPUR RLY.
2012,216,54,112,402,1213,1997,JAMUI
2012,58,16,94,367,1206,1741,JEHANABAD
2012,185,146,274,909,3077,4591,KATIHAR
2012,14,0,16,342,214,586,KATIHAR RLY.
2012,137,36,106,308,1945,2532,KHAGARIA
2012,39,64,144,365,1116,1728,KISHANGANJ
2012,126,26,78,260,948,1438,LAKHISARAI
2012,186,62,154,485,1717,2604,MADHEPURA
2012,148,62,382,995,4003,5590,MADHUBANI
2012,859,44,466,1393,5691,8453,MOTIHARI
2012,100,18,130,402,1387,2037,MUNGER
2012,809,68,558,3344,4078,8857,MUZAFFARPUR
2012,11,4,2,618,313,948,MUZAFFARPUR RLY.
2012,189,22,226,629,4122,5188,NALANDA
2012,142,4,42,147,1282,1617,NAUGACHIA
2012,112,36,178,450,2184,2960,NAWADAH
2012,442,98,752,6937,8636,16865,PATNA
2012,20,4,16,1573,335,1948,PATNA RLY.
2012,325,78,284,446,3013,4146,PURNEA
2012,346,52,260,1406,2334,4398,ROHTAS
2012,251,32,190,468,1755,2696,SAHARSA
2012,340,48,262,807,3824,5281,SAMASTIPUR
2012,417,46,356,1501,3748,6068,SARAN
2012,118,20,78,194,938,1348,SHEIKHPURA
2012,26,4,64,174,535,803,SHEOHAR
2012,132,40,334,1156,3051,4713,SITAMARHI
2012,167,40,386,1009,3354,4956,SIWAN
2012,40,40,236,544,2120,2980,SUPAUL
2012,275,40,446,1897,3535,6193,VAISHALI
2012,17,44,14,228,942,1245,BALOD
2012,42,90,36,573,1854,2595,BALODA BAZAR
2012,57,128,10,140,767,1102,BALRAMPUR
2012,27,48,38,275,1110,1498,BEMETARA
2012,116,94,66,1468,3237,4981,BILASPUR
2012,104,8,6,55,237,410,BIZAPUR
2012,52,14,2,52,358,478,DANTEWARA
2012,24,42,4,294,940,1304,DHAMTARI
2012,96,182,110,1996,5809,8193,DURG
2012,26,38,12,210,705,991,GARIYABAND
2012,4,4,14,397,171,590,GRP RAIPUR
2012,64,72,22,247,1238,1643,JAGDALPUR
2012,67,66,42,1028,2452,3655,JANJGIR
2012,81,160,120,241,899,1501,JASHPUR
2012,37,44,28,211,1184,1504,KABIRDHAM
2012,53,46,18,118,913,1148,KANKER
2012,29,22,14,66,544,675,KONDAGAON
2012,53,86,32,483,1796,2450,KORBA
2012,55,84,26,266,1278,1709,KORIYA
2012,42,56,76,508,1674,2356,MAHASAMUND
2012,22,12,26,280,847,1187,MUNGELI
2012,32,10,12,33,211,298,NARAYANPUR
2012,102,138,30,1150,2112,3532,RAIGARH
2012,102,222,44,3062,5969,9399,RAIPUR
2012,74,62,18,509,2580,3243,RAJNANDGAON
2012,84,146,36,338,1342,1946,SARGUJA
2012,54,2,14,31,219,320,SUKMA
2012,75,148,30,237,1170,1660,SURAJPUR
2012,48,52,30,1329,1154,2613,NORTH GOA
2012,32,58,18,888,880,1876,SOUTH GOA
2012,139,126,458,8572,15440,24735,AHMEDABAD COMMR.
2012,67,10,134,818,3024,4053,AHMEDABAD RURAL
2012,7,2,2,30,278,319,AHWA-DANG
2012,37,20,160,427,1942,2586,AMRELI
2012,49,18,112,685,2474,3338,ANAND
2012,54,24,56,758,2238,3130,BHARUCH
2012,69,26,210,1009,3599,4913,BHAVNAGAR
2012,1,2,0,0,105,108,CID CRIME
2012,47,20,144,646,1181,2038,DAHOD
2012,27,40,58,911,5935,6971,GANDHINAGAR
2012,36,20,114,528,5974,6672,HIMATNAGAR
2012,83,44,82,1455,3984,5648,JAMNAGAR
2012,57,30,126,695,3365,4273,JUNAGADH
2012,32,36,124,500,4714,5406,KHEDA NORTH
2012,34,34,50,632,2620,3370,KUTCH (EAST(G))
2012,29,16,36,417,1558,2056,KUTCH (WEST-BHUJ)
2012,59,20,118,1318,4445,5960,MEHSANA
2012,20,14,12,88,687,821,NARMADA
2012,28,8,30,557,1203,1826,NAVSARI
2012,76,98,236,1205,3797,5412,PALANPUR
2012,70,10,148,621,3167,4016,PANCHMAHAL
2012,33,14,62,673,2671,3453,PATAN
2012,26,20,16,195,798,1055,PORBANDAR
2012,69,22,132,2281,2869,5373,RAJKOT COMMR.
2012,69,40,124,734,3690,4657,RAJKOT RURAL
2012,124,80,182,4183,6568,11137,SURAT COMMR.
2012,71,26,66,1167,2884,4214,SURAT RURAL
2012,66,38,102,563,2507,3276,SURENDRANAGAR
2012,15,10,6,217,716,964,TAPI
2012,63,22,134,3120,4402,7741,VADODARA COMMR.
2012,80,30,146,745,2898,3899,VADODARA RURAL
2012,35,24,50,1285,1932,3326,VALSAD
2012,6,2,4,444,202,658,W.RLY AHMEDABAD
2012,5,0,6,792,206,1009,W.RLY VADODARA
2012,28,22,56,545,721,1372,AMBALA RURAL
2012,31,42,150,1583,1158,2964,AMBALA URBAN
2012,129,56,218,1765,1954,4122,BHIWANI
2012,122,94,206,4045,2428,6895,FARIDABAD
2012,40,30,98,838,966,1972,FATEHABAD
2012,27,2,20,878,718,1645,GRP
2012,148,88,112,7727,2488,10563,GURGAON
2012,143,88,228,2697,2497,5653,HISSAR
2012,114,40,76,1162,1140,2532,JHAJJAR
2012,86,68,116,1359,1244,2873,JIND
2012,51,36,76,898,1062,2123,KAITHAL
2012,119,126,206,2512,2104,5067,KARNAL
2012,64,50,74,1442,1282,2912,KURUKSHETRA
2012,67,28,50,778,1217,2140,MAHENDRAGARH
2012,64,100,58,1084,1385,2691,MEWAT
2012,110,64,108,1296,1572,3150,PALWAL
2012,25,36,80,980,748,1869,PANCHKULA
2012,75,70,174,2102,1560,3981,PANIPAT
2012,71,48,52,1648,1399,3218,REWARI
2012,123,74,70,1856,1587,3710,ROHTAK
2012,53,60,180,1147,1450,2890,SIRSA
2012,153,64,124,1970,2004,4315,SONIPAT
2012,58,50,166,1088,1329,2691,YAMUNANAGAR
2012,11,24,20,113,499,667,BADDIPOLICEDIST
2012,16,24,14,150,869,1073,BILASPUR
2012,7,20,28,118,515,688,CHAMBA
2012,0,0,0,2,108,110,CID
2012,1,0,0,6,113,120,G.R.P.
2012,11,16,12,110,807,956,HAMIRPUR
2012,32,52,104,480,2280,2948,KANGRA
2012,3,12,4,42,247,308,KINNAUR
2012,12,44,14,110,647,827,KULLU
2012,0,4,0,5,198,207,LAHAUL-SPITI
2012,21,56,38,297,1448,1860,MANDI
2012,24,46,58,466,1162,1756,SHIMLA
2012,12,34,22,149,788,1005,SIRMAUR
2012,8,18,16,245,662,949,SOLAN
2012,8,16,14,184,776,998,UNA
2012,23,28,192,268,1035,1546,ANANTNAG
2012,3,8,58,47,389,505,AWANTIPORA
2012,12,12,92,104,427,647,BANDIPORA
2012,33,24,166,257,888,1368,BARAMULLA
2012,14,14,154,432,823,1437,BUDGAM
2012,0,0,0,0,104,104,CRIME JAMMU
2012,0,0,0,2,104,106,CRIME SRINAGAR
2012,18,32,66,122,639,877,DODA
2012,10,18,66,78,414,586,GANDERBAL
2012,26,12,70,104,365,577,HANDWARA
2012,93,78,200,1168,3186,4725,JAMMU
2012,3,2,0,17,194,216,KARGIL
2012,32,40,80,226,1065,1443,KATHUA
2012,14,12,46,59,417,548,KISHTWAR
2012,16,30,140,113,581,880,KULGAM
2012,24,30,100,221,601,976,KUPWARA
2012,4,6,2,18,249,279,LEH
2012,37,18,82,61,753,951,POONCH
2012,9,6,50,88,425,578,PULWAMA
2012,2,0,0,4,114,120,RAILWAYS JAMMU
2012,0,0,2,17,110,129,RAILWAYS KASHMIR
2012,0,0,0,4,104,108,RAILWAYS KATRA
2012,45,64,116,189,1630,2044,RAJOURI
2012,12,14,44,87,746,903,RAMBAN
2012,26,24,36,90,632,808,REASI
2012,25,16,18,112,712,883,SAMBA
2012,24,6,94,218,387,729,SHOPIAN
2012,48,14,68,424,342,896,SOPORE
2012,58,38,200,873,1651,2820,SRINAGAR
2012,24,60,44,123,993,1244,UDHAMPUR
2012,72,92,126,1452,2324,4066,BOKARO
2012,193,68,30,336,587,1214,CHAIBASA
2012,73,30,48,322,772,1245,CHATRA
2012,159,76,96,619,1322,2272,DEOGHAR
2012,87,82,242,2085,3025,5521,DHANBAD
2012,5,4,6,415,245,675,DHANBAD RLY.
2012,100,58,68,511,1086,1823,DUMKA
2012,129,86,48,266,1739,2268,GARHWA
2012,164,74,106,1043,1941,3328,GIRIDIH
2012,49,44,126,340,1528,2087,GODDA
2012,237,72,110,288,503,1210,GUMLA
2012,99,84,106,505,1884,2678,HAZARIBAGH
2012,110,112,196,2167,2325,4910,JAMSHEDPUR
2012,7,2,2,319,133,463,JAMSHEDPUR RLY.
2012,29,54,34,256,666,1039,JAMTARA
2012,125,16,26,74,279,520,KHUNTI
2012,72,16,60,243,885,1276,KODERMA
2012,66,30,56,220,376,748,LATEHAR
2012,55,46,44,127,346,618,LOHARDAGGA
2012,48,106,46,320,687,1207,PAKUR
2012,131,52,114,630,1513,2440,PALAMU
2012,36,52,56,591,621,1356,RAMGARH
2012,222,104,152,1309,1241,3028,RANCHI
2012,101,130,142,296,1092,1761,SAHEBGANJ
2012,73,70,32,500,546,1221,SARAIKELA
2012,94,64,40,153,289,640,SIMDEGA
2012,94,22,34,376,1889,2415,BAGALKOT
2012,720,180,1064,22069,12252,36285,BANGALORE COMMR.
2012,150,62,106,1735,4080,6133,BANGALORE RURAL
2012,262,74,108,1157,5293,6894,BELGAUM
2012,100,36,62,895,2357,3450,BELLARY
2012,77,22,60,483,3213,3855,BIDAR
2012,133,36,60,419,2262,2910,BIJAPUR
2012,95,24,50,800,1909,2878,CBPURA
2012,52,18,20,288,1492,1870,CHAMARAJNAGAR
2012,61,22,24,411,2120,2638,CHICKMAGALUR
2012,81,52,68,595,3429,4225,CHITRADURGA
2012,48,24,20,287,1570,1949,DAKSHIN KANNADA
2012,77,34,46,789,2566,3512,DAVANAGERE
2012,38,12,108,794,1302,2254,DHARWAD COMMR.
2012,57,10,26,150,1175,1418,DHARWAD RURAL
2012,35,12,24,165,925,1161,GADAG
2012,169,58,106,910,3129,4372,GULBARGA
2012,157,42,52,969,4594,5814,HASSAN
2012,43,24,36,333,2006,2442,HAVERI
2012,38,20,14,244,863,1179,K.G.F.
2012,65,24,10,269,1320,1688,KODAGU
2012,104,36,40,489,1781,2450,KOLAR
2012,35,14,54,292,1652,2047,KOPPAL
2012,181,70,92,1399,4627,6369,MANDYA
2012,46,24,32,673,2154,2929,MANGALORE CITY
2012,66,24,26,1682,1678,3476,MYSORE COMMR.
2012,115,56,134,909,3425,4639,MYSORE RURAL
2012,73,38,68,352,2499,3030,RAICHUR
2012,20,4,8,1016,190,1238,RAILWAYS
2012,141,32,120,1471,3409,5173,RAMANAGAR
2012,128,28,64,928,4091,5239,SHIMOGA
2012,171,66,76,1353,4206,5872,TUMKUR
2012,32,10,24,413,2126,2605,UDUPI
2012,56,14,22,278,2507,2877,UTTAR KANNADA
2012,63,18,44,189,1247,1561,YADGIRI
2012,38,88,36,616,7713,8491,ALAPUZHA
2012,19,56,12,773,16164,17024,ERNAKULAM COMMR.
2012,60,118,20,725,9791,10714,ERNAKULAM RURAL
2012,51,106,20,426,4460,5063,IDUKKI
2012,59,132,46,727,7412,8376,KANNUR
2012,37,178,34,418,4503,5170,KASARGOD
2012,62,92,42,648,6340,7184,KOLLAM COMMR.
2012,58,98,28,460,5269,5913,KOLLAM RURAL
2012,49,110,38,758,11242,12197,KOTTAYAM
2012,14,72,10,461,3600,4157,KOZHIKODE COMMR.
2012,33,84,32,528,4988,5665,KOZHIKODE RURAL
2012,42,194,20,788,13127,14171,MALAPPURAM
2012,74,136,26,628,7668,8532,PALAKKAD
2012,52,64,34,460,4767,5377,PATHANAMTHITTA
2012,1,0,8,392,201,602,RAILWAYS
2012,23,70,26,416,5511,6046,THRISSUR COMMR.
2012,67,92,24,595,12402,13180,THRISSUR RURAL
2012,26,82,46,935,6075,7164,TRIVANDRUM COMMR.
2012,91,194,36,1000,8411,9732,TRIVANDRUM RURAL
2012,15,72,24,198,2556,2865,WAYANADU
2012,93,44,26,240,1138,1541,ALIRAJPUR
2012,50,124,16,360,1394,1944,ANUPPUR
2012,49,100,12,293,2202,2656,ASHOK NAGAR
2012,65,156,18,403,2321,2963,BALAGHAT
2012,61,100,16,406,1677,2260,BARWANI
2012,101,236,24,563,2437,3361,BETUL
2012,144,98,54,822,3148,4266,BHIND
2012,174,286,126,6418,9759,16763,BHOPAL
2012,12,8,2,2266,348,2636,BHOPAL RLY.
2012,23,46,12,232,1274,1587,BURHANPUR
2012,110,124,78,779,3661,4752,CHHATARPUR
2012,94,244,42,680,4451,5511,CHHINDWARA
2012,98,100,64,405,2722,3389,DAMOH
2012,85,46,56,391,2078,2656,DATIYA
2012,117,140,62,1209,4357,5885,DEWAS
2012,114,162,98,1179,4497,6050,DHAR
2012,40,80,12,104,1114,1350,DINDORI
2012,89,120,56,791,2883,3939,GUNA
2012,268,170,166,5275,6450,12329,GWALIOR
2012,34,52,24,318,1092,1520,HARDA
2012,76,138,68,598,2655,3535,HOSHANGABAD
2012,295,346,108,10214,14177,25140,INDORE
2012,5,6,6,667,177,861,INDORE RLY.
2012,227,254,102,2268,8435,11286,JABALPUR
2012,7,6,2,1320,373,1708,JABALPUR RLY.
2012,44,124,50,492,1992,2702,JHABUA
2012,58,116,36,540,2791,3541,KATNI
2012,47,132,16,581,2281,3057,KHANDWA
2012,89,134,40,914,3399,4576,KHARGON
2012,41,150,16,215,1989,2411,MANDLA
2012,86,98,68,771,2721,3744,MANDSAUR
2012,163,64,70,1031,4496,5824,MORENA
2012,93,142,32,493,2758,3518,NARSINGHPUR
2012,35,50,24,512,1761,2382,NEEMUCH
2012,49,68,16,199,2013,2345,PANNA
2012,96,184,42,565,3571,4458,RAISEN
2012,76,180,104,884,3838,5082,RAJGARH
2012,92,144,56,804,2647,3743,RATLAM
2012,98,184,88,1562,4120,6052,REWA
2012,172,250,126,1367,7611,9526,SAGAR
2012,110,178,58,1327,4269,5942,SATNA
2012,50,130,20,307,2353,2860,SEONI
2012,57,162,54,548,2770,3591,SHAHDOL
2012,83,134,36,803,2659,3715,SHAJAPUR
2012,23,34,8,269,1183,1517,SHEOPUR
2012,115,208,58,678,4197,5256,SHIVPURI
2012,40,96,80,441,2135,2792,SIDHI
2012,59,138,28,859,3201,4285,SIHORE
2012,45,64,72,305,2090,2576,SINGRAULI
2012,70,122,26,325,2893,3436,TIKAMGARH
2012,248,146,72,2532,6313,9311,UJJAIN
2012,15,44,8,199,1112,1378,UMARIYA
2012,120,188,50,833,3685,4876,VIDISHA
2012,202,122,118,3553,4280,8275,AHMEDNAGAR
2012,76,38,44,1599,2286,4043,AKOLA
2012,62,40,40,1854,1491,3487,AMRAVATI COMMR.
2012,119,128,34,1942,3037,5260,AMRAVATI RURAL
2012,101,46,50,2147,1941,4285,AURANGABAD COMMR.
2012,123,50,32,1356,2520,4081,AURANGABAD RURAL
2012,155,84,100,1459,2736,4534,BEED
2012,31,52,22,1036,1353,2494,BHANDARA
2012,87,58,62,1219,2525,3951,BULDHANA
2012,77,88,68,1755,2449,4437,CHANDRAPUR
2012,89,60,36,907,1740,2832,DHULE
2012,126,36,18,369,664,1213,GADCHIROLI
2012,69,76,20,706,1219,2090,GONDIA
2012,41,26,20,289,1187,1563,HINGOLI
2012,179,90,86,2140,3057,5552,JALGAON
2012,114,50,50,1113,2056,3383,JALNA
2012,102,96,90,2081,2706,5075,KOLHAPUR
2012,130,42,64,1071,2223,3530,LATUR
2012,385,464,424,25391,12229,38893,MUMBAI COMMR.
2012,11,2,14,3700,279,4006,MUMBAI RLY.
2012,173,114,106,6094,3930,10417,NAGPUR COMMR.
2012,10,2,4,2220,227,2463,NAGPUR RLY.
2012,85,58,30,1993,2291,4457,NAGPUR RURAL
2012,138,96,74,1337,3422,5067,NANDED
2012,52,38,20,430,1036,1576,NANDURBAR
2012,58,40,36,2686,2579,5399,NASIK COMMR.
2012,150,92,58,1574,3787,5661,NASIK RURAL
2012,77,72,38,4052,1989,6228,NAVI MUMBAI
2012,85,76,62,850,2251,3324,OSMANABAD
2012,97,56,62,1132,1842,3189,PARBHANI
2012,234,170,218,10197,4997,15816,PUNE COMMR.
2012,4,4,2,756,141,907,PUNE RLY.
2012,260,184,142,4725,4712,10023,PUNE RURAL
2012,53,42,16,853,1429,2393,RAIGAD
2012,22,22,8,554,963,1569,RATNAGIRI
2012,88,66,70,1238,1693,3155,SANGLI
2012,113,86,72,2999,2735,6005,SATARA
2012,15,18,16,284,570,903,SINDHUDURG
2012,45,50,48,1423,993,2559,SOLAPUR COMMR.
2012,144,134,76,2032,2902,5288,SOLAPUR RURAL
2012,203,214,248,6864,4227,11756,THANE COMMR.
2012,220,126,128,3929,3299,7702,THANE RURAL
2012,62,80,52,1618,2377,4189,WARDHA
2012,71,62,58,772,1602,2565,WASHIM
2012,142,128,130,2365,4514,7279,YAVATMAL
2012,46,22,24,97,284,473,BISHNUPUR
2012,19,0,10,14,135,178,CHANDEL
2012,14,2,12,71,142,241,CHURACHANDPUR
2012,0,0,0,0,104,104,CID
2012,101,20,92,447,357,1017,IMPHAL EAST
2012,163,36,144,1083,679,2105,IMPHAL WEST
2012,21,4,44,70,169,308,SENAPATI
2012,16,2,14,22,132,186,TAMENGLONG
2012,89,40,88,209,470,896,THOUBAL
2012,23,0,18,28,133,202,UKHRUL
2012,20,4,18,99,150,291,GARO HILLS EAST
2012,18,12,30,89,148,297,GARO HILLS SOUTH
2012,25,12,38,216,397,688,GARO HILLS WEST
2012,55,64,36,160,274,589,JAINTIA HILLS
2012,39,116,36,532,468,1191,KHASI HILLS EAST
2012,29,56,12,87,185,369,KHASI HILLS WEST
2012,14,64,14,147,217,456,RI-BHOI
2012,25,84,4,774,374,1261,AIZAWL
2012,6,24,2,252,142,426,CHAMPHAI
2012,5,18,2,141,164,330,KOLASIB
2012,3,14,2,77,135,231,LAWNGTLAI
2012,6,32,2,125,132,297,LUNGLEI
2012,3,20,2,63,126,214,MAMIT
2012,0,0,2,62,129,193,SAIHA
2012,3,14,0,69,130,216,SERCHHIP
2012,34,18,32,460,271,815,DIMAPUR
2012,6,0,0,4,105,115,KIPHIRE
2012,21,2,6,168,143,340,KOHIMA
2012,2,0,0,2,114,118,LONGLENG
2012,11,6,0,29,127,173,MOKOKCHUNG
2012,9,6,8,42,124,189,MON
2012,6,0,2,23,110,141,PEREN
2012,4,2,0,28,120,154,PHEK
2012,6,2,0,28,119,155,TUENSANG
2012,5,4,0,57,127,193,WOKHA
2012,13,2,6,41,125,187,ZUNHEBOTO
2012,128,126,118,1351,2486,4209,ANGUL
2012,126,174,280,1190,2876,4646,BALASORE
2012,123,70,72,528,1104,1897,BARAGARH
2012,149,36,48,770,1121,2124,BERHAMPUR
2012,94,108,144,456,2028,2830,BHADRAK
2012,115,102,84,594,1357,2252,BOLANGIR
2012,35,20,20,145,525,745,BOUDH
2012,70,86,126,652,2304,3238,CUTTACK
2012,118,112,182,3153,2762,6327,DCP BBSR
2012,58,56,88,1366,1687,3255,DCP CTC
2012,39,34,14,102,390,579,DEOGARH
2012,156,58,82,693,1081,2070,DHENKANAL
2012,31,36,28,53,333,481,GAJAPATI
2012,345,106,134,652,1071,2308,GANJAM
2012,64,86,114,965,1398,2627,JAGATSINGHPUR
2012,105,98,126,1060,1863,3252,JAJPUR
2012,34,42,26,710,774,1586,JHARSUGUDA
2012,81,130,94,327,1191,1823,KALAHANDI
2012,29,64,60,219,574,946,KANDHAMAL
2012,70,76,138,532,1629,2445,KENDRAPARA
2012,180,204,148,786,1440,2758,KEONJHAR
2012,91,54,106,433,1099,1783,KHURDA
2012,105,146,72,437,883,1643,KORAPUT
2012,84,34,44,133,310,605,MALKANGIR
2012,140,172,134,650,1595,2691,MAYURBHANJ
2012,137,50,86,411,834,1518,NAYAGARH
2012,59,84,90,190,747,1170,NOWRANGPUR
2012,50,36,38,165,734,1023,NUAPADA
2012,128,84,110,1275,2835,4432,PURI
2012,75,82,86,281,659,1183,RAYAGADA
2012,128,130,46,1038,978,2320,ROURKELA
2012,108,114,68,1152,1530,2972,SAMBALPUR
2012,42,24,18,157,415,656,SONEPUR
2012,11,0,4,1113,201,1329,SRP(CUTTACK)
2012,12,2,6,602,202,824,SRP(ROURKELA)
2012,107,80,50,463,919,1619,SUNDARGARH
2012,107,36,90,456,725,1414,AMRITSAR RURAL
2012,39,50,18,223,497,827,BARNALA
2012,62,50,46,372,713,1243,BATALA
2012,112,88,92,795,1040,2127,BHATINDA
2012,122,54,104,1031,957,2268,CP AMRITSAR
2012,60,66,78,1103,809,2116,CP JALANDHAR
2012,157,138,246,1246,1711,3498,CP LUDHIANA
2012,48,34,48,304,514,948,FARIDKOT
2012,28,30,20,231,571,880,FATEHGARH SAHIB
2012,67,64,80,335,623,1169,FAZILKA
2012,80,30,40,499,762,1411,FEROZPUR
2012,10,0,0,111,393,514,G.R.P
2012,46,28,74,261,577,986,GURDASPUR
2012,76,66,82,685,992,1901,HOSHIARPUR
2012,98,58,76,536,987,1755,JALANDHAR RURAL
2012,69,32,86,603,867,1657,KAPURTHALA
2012,43,28,30,352,586,1039,KHANNA
2012,56,22,64,282,548,972,LUDHIANA RURAL
2012,40,44,34,185,484,787,MANSA
2012,81,46,40,426,721,1314,MOGA
2012,55,36,70,298,562,1021,MUKTSAR
2012,17,26,26,125,409,603,PATHANKOT
2012,106,88,90,818,1628,2730,PATIALA
2012,28,44,42,522,743,1379,ROPAR
2012,86,68,78,490,1557,2279,SANGRUR
2012,73,46,104,910,1328,2461,SAS NGR
2012,34,42,34,264,478,852,SBS NAGAR
2012,100,46,46,354,692,1238,TARN TARAN
2012,74,140,214,1433,4324,6185,AJMER
2012,188,258,486,6747,6580,14259,ALWAR
2012,50,112,192,346,2260,2960,BANSWARA
2012,88,138,168,729,2537,3660,BARAN
2012,59,42,70,892,2803,3866,BARMER
2012,168,216,424,3066,5978,9852,BHARATPUR
2012,71,118,156,1422,3290,5057,BHILWARA
2012,118,134,82,676,3205,4215,BIKANER
2012,50,86,162,544,2357,3199,BUNDI
2012,63,118,192,1015,3229,4617,CHITTORGARH
2012,80,118,74,475,2474,3221,CHURU
2012,47,28,202,1936,3547,5760,DAUSA
2012,118,64,158,753,2958,4051,DHOLPUR
2012,38,64,134,171,1551,1958,DUNGARPUR
2012,6,8,16,1225,236,1491,G.R.P.AJMER
2012,2,2,2,167,145,318,G.R.P.JODHPUR
2012,117,154,158,799,3722,4950,GANGANAGAR
2012,107,184,126,545,2949,3911,HANUMANGARH
2012,45,82,122,5501,2665,8415,JAIPUR EAST
2012,32,74,128,1295,1630,3159,JAIPUR NORTH
2012,75,78,192,1362,3868,5575,JAIPUR RURAL
2012,34,34,52,2487,2036,4643,JAIPUR SOUTH
2012,46,76,138,2547,2646,5453,JAIPUR WEST
2012,17,24,18,275,909,1243,JAISALMER
2012,41,26,94,462,1954,2577,JALORE
2012,91,162,182,746,2803,3984,JHALAWAR
2012,51,90,126,718,3303,4288,JHUNJHUNU
2012,39,40,30,860,1403,2372,JODHPUR EAST
2012,72,54,66,527,2194,2913,JODHPUR RURAL
2012,57,40,58,1439,1122,2716,JODHPUR WEST
2012,81,88,208,1421,3474,5272,KARAULI
2012,96,90,164,1312,2286,3948,KOTA CITY
2012,76,84,98,323,1764,2345,KOTA RURAL
2012,107,106,258,849,3163,4483,NAGAUR
2012,112,122,214,865,4209,5522,PALI
2012,56,274,160,324,1976,2790,PRATAPGARH
2012,45,28,124,472,1769,2438,RAJSAMAND
2012,51,38,190,1256,2937,4472,SAWAI MADHOPUR
2012,85,110,192,1387,3980,5754,SIKAR
2012,45,58,138,302,1377,1920,SIROHI
2012,45,38,138,543,2553,3317,TONK
2012,156,298,380,1936,5245,8015,UDAIPUR
2012,7,26,12,108,189,342,EAST
2012,2,0,0,19,121,142,NORTH
2012,3,24,6,101,177,311,SOUTH
2012,2,18,2,77,158,257,WEST
2012,51,22,94,312,2227,2706,ARIYALUR
2012,399,188,174,4971,15690,21422,CHENNAI
2012,6,0,4,449,414,873,CHENNAI RLY.
2012,79,18,82,909,4382,5470,COIMBATORE RURAL
2012,66,40,40,1316,9425,10887,COIMBATORE URBAN
2012,190,80,304,1281,10172,12027,CUDDALORE
2012,82,50,196,405,3294,4027,DHARMAPURI
2012,163,32,194,573,5289,6251,DINDIGUL
2012,71,16,60,827,4138,5112,ERODE
2012,189,38,34,1286,7012,8559,KANCHIPURAM
2012,163,24,66,775,4023,5051,KANYAKUMARI
2012,44,8,98,340,2156,2646,KARUR
2012,104,28,90,508,3670,4400,KRISHNAGIRI
2012,218,60,166,1066,4970,6480,MADURAI RURAL
2012,105,22,130,1067,2247,3571,MADURAI URBAN
2012,100,20,84,488,3857,4549,NAGAPATTINAM
2012,63,24,96,322,3710,4215,NAMAKKAL
2012,31,18,16,154,1118,1337,NILGIRIS
2012,26,6,62,217,1322,1633,PERAMBALUR
2012,67,12,66,335,2864,3344,PUDUKOTTAI
2012,135,18,80,486,3087,3806,RAMNATHAPURAM
2012,100,72,158,500,5353,6183,SALEM RURAL
2012,38,30,46,398,2072,2584,SALEM URBAN
2012,105,22,86,522,3086,3821,SIVAGANGAI
2012,159,28,114,1115,5782,7198,THANJAVUR
2012,108,44,90,594,3682,4518,THENI
2012,376,88,104,750,7842,9160,THIRUNELVELI RURAL
2012,182,6,14,172,1078,1452,THIRUNELVELI URBAN
2012,89,36,28,548,3164,3865,THIRUVALLUR
2012,108,42,124,579,4363,5216,THIRUVANNAMALAI
2012,78,22,68,441,3728,4337,THIRUVARUR
2012,293,52,82,761,4457,5645,THOOTHUGUDI
2012,146,16,102,1528,5743,7535,TIRUPPUR
2012,5,0,2,168,224,399,TRICHY RLY.
2012,88,28,58,325,4181,4680,TRICHY RURAL
2012,48,14,44,604,2490,3200,TRICHY URBAN
2012,158,48,152,1212,6695,8265,VELLORE
2012,311,156,404,1450,8807,11128,VILLUPURAM
2012,159,46,78,709,4713,5705,VIRUDHUNAGAR
2012,28,70,22,90,365,575,DHALAI
2012,26,52,32,299,965,1374,GOMATI
2012,1,0,0,10,107,118,GRP
2012,16,20,10,85,410,541,KHOWAI
2012,21,58,32,115,455,681,NORTH
2012,21,46,58,215,830,1170,SIPAHIJALA
2012,35,60,34,138,640,907,SOUTH
2012,17,52,20,104,474,667,UNAKOTI
2012,38,100,70,380,1044,1632,WEST
2012,323,116,642,7588,3959,12628,AGRA
2012,327,128,596,3039,2909,6999,ALIGARH
2012,229,104,446,2950,3829,7558,ALLAHABAD
2012,67,24,138,301,876,1406,AMBEDKAR NAGAR
2012,53,26,204,351,928,1562,AURAIYA
2012,161,38,242,612,1502,2555,AZAMGARH
2012,244,48,214,542,1814,2862,BADAUN
2012,173,36,160,618,888,1875,BAGHPAT
2012,83,54,232,521,1714,2604,BAHRAICH
2012,72,24,168,613,1045,1922,BALLIA
2012,33,24,106,165,393,721,BALRAMPUR
2012,64,44,96,319,878,1401,BANDA
2012,124,62,260,463,1397,2306,BARABANKI
2012,265,172,530,1741,3094,5802,BAREILLY
2012,52,14,122,370,893,1451,BASTI
2012,173,46,186,699,1153,2257,BHIM NAGAR
2012,156,86,320,848,2022,3432,BIJNOR
2012,284,92,376,1198,2100,4050,BULANDSHAHAR
2012,39,22,68,288,804,1221,CHANDOLI
2012,44,62,86,271,505,968,CHITRAKOOT DHAM
2012,90,52,210,354,1062,1768,CSM NAGAR
2012,60,36,134,416,989,1635,DEORIA
2012,188,44,220,865,1526,2843,ETAH
2012,114,18,142,634,1396,2304,ETAWAH
2012,86,58,286,650,1556,2636,FAIZABAD
2012,134,28,212,628,932,1934,FATEHGARH
2012,112,70,236,348,1543,2309,FATEHPUR
2012,208,64,386,1422,1696,3776,FIROZABAD
2012,33,6,28,3721,862,4650,G.R.P.
2012,192,38,316,6223,2622,9391,GAUTAMBUDH NAGAR
2012,257,62,510,5744,3467,10040,GHAZIABAD
2012,103,18,122,455,921,1619,GHAZIPUR
2012,77,46,250,613,1588,2574,GONDA
2012,234,104,464,2222,2296,5320,GORAKHPUR
2012,63,50,92,194,597,996,HAMIRPUR
2012,134,60,270,556,2292,3312,HARDOI
2012,105,34,168,700,1096,2103,HATHRAS
2012,96,68,138,562,1038,1902,J.P.NAGAR
2012,78,30,136,362,902,1508,JALAUN
2012,114,30,230,480,1242,2096,JAUNPUR
2012,115,38,148,804,1311,2416,JHANSI
2012,84,24,172,304,1285,1869,KANNAUJ
2012,277,110,636,3410,3750,8183,KANPUR NAGAR
2012,104,36,130,299,757,1326,KANSHIRAM NAGAR
2012,56,22,108,239,1010,1435,KAUSHAMBI
2012,187,68,364,910,1957,3486,KHIRI
2012,64,60,196,342,1255,1917,KUSHI NAGAR
2012,33,28,50,148,535,794,LALITPUR
2012,240,96,630,5475,6071,12512,LUCKNOW
2012,51,68,190,247,1076,1632,MAHARAJGANJ
2012,45,32,96,223,536,932,MAHOBA
2012,165,30,278,941,1479,2893,MAINPURI
2012,222,82,310,1831,2737,5182,MATHURA
2012,84,18,164,498,941,1705,MAU
2012,448,108,574,5350,3635,10115,MEERUT
2012,30,8,14,107,691,850,MIRZAPUR
2012,174,72,324,1904,2041,4515,MORADABAD
2012,260,54,434,1331,2273,4352,MUZAFFARNAGAR
2012,124,30,130,802,1076,2162,PANCHSHIL NAGAR
2012,68,20,130,191,1955,2364,PILIBHIT
2012,113,14,128,405,869,1529,PRABUDDH NAGAR
2012,138,72,232,623,1542,2607,PRATAPGARH
2012,76,72,192,440,1244,2024,RAIBAREILLY
2012,58,36,166,200,1669,2129,RAMABAI NAGAR
2012,117,52,200,798,1250,2417,RAMPUR
2012,148,36,202,964,2249,3599,SAHARANPUR
2012,33,36,100,152,573,894,SANT KABIRNAGAR
2012,157,54,260,517,1911,2899,SHAHJAHANPUR
2012,34,44,84,155,408,725,SHRAWASTI
2012,32,44,96,190,546,908,SIDHARTHNAGAR
2012,177,98,482,959,2179,3895,SITAPUR
2012,38,42,62,234,680,1056,SONBHADRA
2012,30,8,36,114,387,575,ST.RAVIDASNAGAR
2012,124,52,134,706,1174,2190,SULTANPUR
2012,106,82,364,507,1887,2946,UNNAO
2012,121,42,198,1522,1994,3877,VARANASI
2012,10,10,0,56,189,265,ALMORA
2012,5,16,2,14,144,181,BAGESHWAR
2012,4,4,4,26,140,178,CHAMOLI
2012,3,6,0,21,157,187,CHAMPAWAT
2012,66,60,86,1291,1190,2693,DEHRADUN
2012,128,94,212,1388,1430,3252,HARIDWAR
2012,29,32,58,258,564,941,NAINITAL
2012,11,4,20,138,226,399,PAURI GARHWAL
2012,9,2,2,32,161,206,PITHORAGARH
2012,3,4,6,29,161,203,RUDRA PRAYAG
2012,7,2,6,42,160,217,TEHRI GARHWAL
2012,102,60,190,1073,1407,2832,UDHAMSINGH NAGAR
2012,1,2,8,25,153,189,UTTARKASHI
2012,248,236,994,3047,8898,13423,24 PARGANAS NORTH
2012,232,488,838,2736,11757,16051,24 PARGANAS SOUTH
2012,85,72,154,2049,2626,4986,ASANSOL
2012,98,70,168,510,2166,3012,BANKURA
2012,50,26,106,1777,2241,4200,BDN CP
2012,299,98,152,875,2021,3445,BIRBHUM
2012,138,72,428,2831,4471,7940,BKP CP
2012,258,116,198,1064,3367,5003,BURDWAN
2012,142,184,358,597,2618,3899,COOCHBEHAR
2012,291,132,284,513,1879,3099,DAKSHIN DINAJPUR
2012,44,20,94,651,1142,1951,DARJEELING
2012,169,136,354,1749,4762,7170,HOOGHLY
2012,99,112,264,1023,3988,5486,HOWRAH
2012,42,56,382,2426,3771,6677,HOWRAH CITY
2012,25,4,8,659,209,905,HOWRAH G.R.P.
2012,273,326,668,2992,5300,9559,JALPAIGURI
2012,53,42,42,227,537,901,JHARGRAM
2012,6,4,8,306,131,455,KHARAGPUR G.R.P.
2012,239,136,542,10088,16716,27721,KOLKATA
2012,440,316,580,901,4042,6279,MALDA
2012,569,514,1158,2065,9420,13726,MURSHIDABAD
2012,503,348,866,2637,8980,13334,NADIA
2012,174,128,230,1252,3832,5616,PASCHIM MIDNAPUR
2012,87,130,392,981,4014,5604,PURAB MIDNAPUR
2012,78,100,88,553,1357,2176,PURULIA
2012,28,0,14,893,222,1157,SEALDAH G.R.P.
2012,5,0,6,336,167,514,SILIGURI G.R.P.
2012,38,42,246,1738,1767,3831,SILIGURI_PC
2012,393,184,612,940,3778,5907,UTTAR DINAJPUR
2012,2,0,2,9,117,130,CAR
2012,5,8,0,33,185,231,NORTH
2012,11,16,14,178,453,672,SOUTH
2012,65,54,174,3408,1354,5055,CHANDIGARH
2012,9,6,26,162,287,490,D and N HAVELI
2012,7,10,4,132,199,352,DAMAN
2012,1,0,2,8,133,144,DIU
2012,0,0,0,0,282,282,CAW
2012,60,62,360,2959,965,4406,CENTRAL
2012,3,2,6,2,125,138,CRIME BRANCH
2012,101,180,1006,6749,2993,11029,EAST
2012,0,0,0,0,106,106,EOW
2012,13,8,54,1273,221,1569,GRP(RLY)
2012,1,0,2,138,160,301,IGI AIRPORT
2012,15,10,56,782,529,1392,NEW DELHI
2012,42,28,306,2192,1233,3801,NORTH
2012,114,156,1020,5352,2341,8983,NORTH-EAST
2012,97,128,714,4039,1776,6754,NORTH-WEST
2012,156,134,1144,4791,2716,8941,OUTER
2012,58,140,490,4541,2010,7239,SOUTH
2012,115,232,1076,6061,2788,10272,SOUTH-EAST
2012,95,174,798,2601,1887,5555,SOUTH-WEST
2012,1,0,0,0,107,108,STF
2012,89,158,908,4948,2143,8246,WEST
2012,0,0,0,17,153,170,LAKSHADWEEP
2012,11,12,4,187,746,960,KARAIKAL
2012,45,14,34,1242,2764,4099,PUDUCHERRY
